Fecha,Lugar,I. CRIMINALIDAD CONVENCIONAL,1. Homicidios dolosos y asesinatos consumados,2. Homicidios dolosos y asesinatos en grado tentativa,3. Delitos graves y menos graves de lesiones y riña tumultuaria,4. Secuestro,5. Delitos contra la libertad sexual,5.1.-Agresión sexual con penetración,5.2.-Resto de delitos contra la libertad sexual,6. Robos con violencia e intimidación,"7. Robos con fuerza en domicilios, establecimientos y otras instalaciones",7.1.-Robos con fuerza en domicilios,8. Hurtos,9. Sustracciones de vehículos,10. Tráfico de drogas,11. Resto de criminalidad convencional,II. CIBERCRIMINALIDAD (infracciones penales cometidas en/por medio ciber),12.-Estafas informáticas,13.-Otros ciberdelitos,III. TOTAL INFRACCIONES PENALES
2022,ANDALUCÍA,322225,74,284,4855,21,2659,512,2147,7335,18819,13281,89038,5578,4616,188946,56908,49323,7585,379133
2022,Provincia de ALMERÍA,26428,9,29,514,1,287,58,229,677,1923,1530,5525,312,510,16641,3483,3041,442,29911
2022,04003 Adra,732,0,0,17,0,5,1,4,14,53,48,134,5,24,480,53,47,6,785
2022,04013 Almería,7391,2,8,91,0,55,8,47,221,437,359,2099,138,200,4140,1541,1387,154,8932
2022,04902 Ejido (El),3254,2,3,100,0,48,7,41,107,186,137,689,37,68,2014,378,345,33,3632
2022,04053 Huércal-Overa,563,0,1,12,0,6,2,4,4,55,49,90,9,4,382,84,72,12,647
2022,04066 Níjar,1364,0,1,35,0,18,6,12,14,92,66,198,13,14,979,77,62,15,1441
2022,04079 Roquetas de Mar,5493,1,4,126,0,61,25,36,211,326,266,1108,37,65,3554,354,277,77,5847
2022,04102 Vícar,1120,0,2,26,0,9,1,8,28,101,81,206,7,21,720,104,88,16,1224
2022,Provincia de CÁDIZ,45968,10,34,739,2,385,71,314,824,2530,1575,12227,1103,883,27231,10306,8982,1324,56274
2022,11004 Algeciras,4938,6,5,110,1,50,12,38,69,189,139,943,109,223,3233,727,622,105,5665
2022,11006 Arcos de la Frontera,786,0,0,9,0,5,0,5,9,62,45,183,15,9,494,91,72,19,877
2022,11007 Barbate,1211,0,0,23,0,5,2,3,15,52,30,350,1,12,753,123,100,23,1334
2022,11008 Barrios (Los),1054,0,1,18,0,6,2,4,10,36,29,272,10,11,690,189,171,18,1243
2022,11012 Cádiz,4356,0,2,38,0,42,10,32,98,208,85,1741,183,58,1986,1319,1178,141,5675
2022,11015 Chiclana de la Frontera,3138,2,0,34,0,18,3,15,28,313,220,763,76,22,1882,608,533,75,3746
2022,11014 Conil de la Frontera,1031,0,0,19,0,10,3,7,18,97,69,241,12,13,621,180,160,20,1211
2022,11020 Jerez de la Frontera,8797,1,11,132,0,71,10,61,262,375,233,2767,219,97,4862,2304,2036,268,11101
2022,11022 Línea de la Concepción (La),1988,1,2,48,0,25,2,23,29,54,23,255,59,76,1439,305,280,25,2293
2022,11027 Puerto de Santa María (El),3575,0,1,51,0,33,6,27,82,161,83,1088,98,61,2000,813,706,107,4388
2022,11028 Puerto Real,1456,0,0,8,0,15,0,15,18,103,38,430,13,11,858,474,403,71,1930
2022,11030 Rota,1169,0,1,12,0,12,3,9,17,95,65,306,29,12,685,290,267,23,1459
2022,11031 San Fernando,3001,0,0,28,0,22,5,17,59,98,50,996,93,22,1683,1119,950,169,4120
2022,11033 San Roque,1391,0,1,28,0,10,2,8,10,59,45,202,18,24,1039,241,189,52,1632
2022,11032 Sanlúcar de Barrameda,2594,0,4,24,0,14,5,9,35,169,82,639,112,111,1486,625,549,76,3219
2022,Provincia de CÓRDOBA,23037,3,15,292,0,212,39,173,364,1298,961,6072,235,149,14397,5414,4632,782,28451
2022,14013 Cabra,493,0,0,1,0,7,0,7,8,40,34,97,6,8,326,186,157,29,679
2022,14021 Córdoba,12074,0,5,104,0,128,26,102,239,409,293,3980,171,77,6961,2929,2503,426,15003
2022,14038 Lucena,1645,0,1,16,0,11,2,9,30,83,56,339,15,9,1141,403,343,60,2048
2022,14042 Montilla,341,0,0,11,0,3,0,3,5,28,20,74,3,3,214,134,119,15,475
2022,14049 Palma del Río,719,0,2,21,0,2,0,2,7,28,14,163,3,2,491,87,71,16,806
2022,14055 Priego de Córdoba,398,0,1,3,0,8,1,7,2,42,36,106,0,3,233,84,77,7,482
2022,14056 Puente Genil,849,1,0,13,0,8,0,8,15,73,53,183,7,14,535,193,172,21,1042
2022,Provincia de GRANADA,31968,14,31,414,0,275,59,216,682,1903,1439,7626,368,1035,19620,5429,4700,729,37397
2022,18017 Almuñécar,1063,0,2,13,0,5,1,4,9,90,77,306,13,18,607,184,159,25,1247
2022,18021 Armilla,1571,0,3,16,0,9,4,5,15,25,15,828,5,12,658,197,165,32,1768
2022,18023 Baza,708,0,0,8,0,7,1,6,6,53,37,150,11,6,467,105,84,21,813
2022,18905 Gabias (Las),788,0,1,13,0,8,1,7,15,42,35,289,2,13,405,189,161,28,977
2022,18087 Granada,10574,3,8,84,0,94,23,71,409,490,353,3195,171,285,5835,1416,1215,201,11990
2022,18122 Loja,439,0,0,7,0,3,0,3,14,39,29,86,3,16,271,96,82,14,535
2022,18127 Maracena,551,0,0,6,0,1,0,1,11,20,13,90,12,11,400,166,144,22,717
2022,18140 Motril,2096,0,3,23,0,23,5,18,50,108,74,527,29,46,1287,434,398,36,2530
2022,Provincia de HUELVA,19264,3,12,370,1,184,27,157,359,1161,880,4664,276,183,12051,2081,1681,400,21345
2022,21002 Aljaraque,434,1,0,5,0,3,0,3,1,40,26,77,5,8,294,171,147,24,605
2022,21005 Almonte,1346,1,1,28,0,4,2,2,16,106,93,382,11,12,785,132,111,21,1478
2022,21010 Ayamonte,775,0,0,14,0,12,4,8,15,82,56,101,18,12,521,66,51,15,841
2022,21021 Cartaya,1244,0,1,37,0,7,3,4,25,76,51,287,6,6,799,92,68,24,1336
2022,21041 Huelva,6285,0,5,95,1,77,6,71,163,195,119,2106,125,35,3483,815,685,130,7100
2022,21042 Isla Cristina,780,0,1,31,0,5,0,5,17,37,31,117,9,19,544,32,27,5,812
2022,21044 Lepe,2025,0,1,40,0,17,2,15,48,134,104,564,19,5,1197,99,74,25,2124
2022,21050 Moguer,785,0,0,25,0,8,4,4,12,34,27,119,10,12,565,38,24,14,823
2022,Provincia de JAÉN,16115,6,17,239,0,134,26,108,232,1053,769,3357,153,157,10767,3742,3207,535,19857
2022,23002 Alcalá la Real,564,1,0,19,0,5,1,4,2,53,47,91,2,2,389,132,115,17,696
2022,23005 Andújar,962,1,1,8,0,4,1,3,10,37,17,238,6,8,649,172,155,17,1134
2022,23050 Jaén,3777,2,5,48,0,33,4,29,110,223,160,1078,88,37,2153,1030,874,156,4807
2022,23055 Linares,1270,0,3,15,0,11,1,10,26,84,56,314,22,32,763,376,308,68,1646
2022,23060 Martos,597,0,0,7,0,8,2,6,9,54,43,105,1,6,407,125,107,18,722
2022,23092 Úbeda,854,0,1,10,0,4,0,4,16,68,50,266,3,7,479,200,174,26,1054
2022,Provincia de MÁLAGA,79927,17,63,1115,12,628,122,506,1742,4514,3348,25167,1742,1102,43825,11863,10230,1633,91790
2022,29007 Alhaurín de la Torre,1120,0,0,13,0,10,1,9,17,77,68,173,20,11,799,360,301,59,1480
2022,29008 Alhaurín el Grande,720,0,0,16,0,8,1,7,8,69,64,101,5,9,504,130,111,19,850
2022,29015 Antequera,1228,0,0,9,0,10,2,8,20,77,52,344,14,9,745,300,255,45,1528
2022,29025 Benalmádena,3439,1,1,54,1,26,11,15,62,157,114,1007,67,61,2002,680,593,87,4119
2022,29038 Cártama,988,0,1,25,0,8,2,6,12,60,54,139,10,7,726,179,153,26,1167
2022,29042 Coín,730,0,0,13,0,11,3,8,13,67,53,120,13,7,486,125,96,29,855
2022,29051 Estepona,3560,1,6,49,0,34,10,24,71,291,247,852,67,72,2117,489,410,79,4049
2022,29054 Fuengirola,5390,0,3,86,0,56,6,50,151,230,152,2403,138,78,2245,460,410,50,5850
2022,29067 Málaga,28203,9,25,357,0,235,45,190,686,1139,736,10456,664,376,14256,3645,3108,537,31848
2022,29069 Marbella,12753,2,13,150,7,67,16,51,298,840,597,3900,329,151,6996,916,711,205,13669
2022,29070 Mijas,4211,0,4,48,2,29,5,24,102,312,274,1006,103,66,2539,845,770,75,5056
2022,29075 Nerja,969,0,0,32,0,4,1,3,30,61,55,348,9,6,479,175,149,26,1144
2022,29082 Rincón de la Victoria,1222,0,3,12,0,10,1,9,16,85,63,255,19,12,810,365,334,31,1587
2022,29084 Ronda,1133,0,0,11,0,5,0,5,22,77,40,405,7,17,589,319,298,21,1452
2022,29901 Torremolinos,4380,1,1,65,1,25,5,20,88,139,74,1515,79,92,2374,701,612,89,5081
2022,29094 Vélez-Málaga,3314,1,1,40,1,25,3,22,71,215,153,949,115,36,1860,719,660,59,4033
2022,Provincia de SEVILLA,79518,12,83,1172,5,554,110,444,2455,4437,2779,24400,1389,597,44414,14590,12850,1740,94108
2022,41004 Alcalá de Guadaíra,3031,1,5,19,0,28,5,23,53,234,145,840,70,57,1724,510,436,74,3541
2022,41017 Bormujos,543,0,0,8,1,9,0,9,12,67,40,126,2,5,313,84,61,23,627
2022,41021 Camas,1060,1,0,8,0,9,3,6,11,27,17,303,29,13,659,318,301,17,1378
2022,41024 Carmona,1142,0,1,33,0,4,1,3,13,174,129,174,5,7,731,125,105,20,1267
2022,41034 Coria del Río,1419,1,1,12,0,9,0,9,29,65,49,338,30,13,921,144,132,12,1563
2022,41038 Dos Hermanas,5149,2,7,61,0,31,5,26,106,284,187,1344,48,44,3222,1218,1080,138,6367
2022,41039 Écija,1108,0,3,21,0,7,4,3,19,74,51,279,20,6,679,181,162,19,1289
2022,41053 Lebrija,794,0,1,22,0,6,1,5,2,33,16,185,10,9,526,265,230,35,1059
2022,41058 Mairena del Alcor,501,0,0,22,0,3,1,2,3,58,38,79,3,4,329,66,63,3,567
2022,41059 Mairena del Aljarafe,1593,0,1,28,0,12,2,10,20,94,68,430,12,6,990,274,236,38,1867
2022,41065 Morón de la Frontera,694,0,1,8,0,6,2,4,12,51,45,136,10,12,458,144,133,11,838
2022,41069 Palacios y Villafranca (Los),1255,0,0,24,0,3,0,3,19,96,70,371,4,10,728,362,312,50,1617
2022,41081 Rinconada (La),1305,0,0,48,0,10,0,10,23,123,55,244,17,12,828,115,91,24,1420
2022,41086 San Juan de Aznalfarache,1223,0,1,8,0,14,1,13,22,33,30,499,18,18,610,146,141,5,1369
2022,41091 Sevilla,41700,5,37,338,3,301,59,242,1853,1560,820,16102,986,232,20283,7515,6757,758,49215
2022,41093 Tomares,455,0,0,3,0,1,0,1,8,51,31,147,2,2,241,114,99,15,569
2022,41095 Utrera,1655,0,0,42,0,9,1,8,19,129,76,456,3,13,984,499,417,82,2154
2022,ARAGÓN,38269,10,27,711,1,379,89,290,1195,2423,1493,10629,279,420,22195,9620,8732,888,47889
2022,Provincia de HUESCA,5793,0,2,138,0,74,18,56,80,347,241,1287,36,65,3764,1539,1389,150,7332
2022,22125 Huesca,1272,0,1,50,0,22,9,13,20,60,41,423,11,19,666,345,335,10,1617
2022,Provincia de TERUEL,2724,1,3,62,0,25,4,21,18,261,201,413,18,30,1893,854,775,79,3578
2022,44216 Teruel,651,1,2,22,0,8,1,7,9,42,32,131,3,7,426,158,142,16,809
2022,Provincia de ZARAGOZA,29752,9,22,511,1,280,67,213,1097,1815,1051,8929,225,325,16538,7227,6568,659,36979
2022,50297 Zaragoza,20823,5,18,319,0,211,61,150,1006,1090,612,7346,187,263,10378,4965,4544,421,25788
2022,ASTURIAS (PRINCIPADO DE),23533,6,16,454,1,238,46,192,392,1194,830,6810,239,170,14013,8560,7661,899,32093
2022,Provincia de ASTURIAS,23533,6,16,454,1,238,46,192,392,1194,830,6810,239,170,14013,8560,7661,899,32093
2022,33004 Avilés,1695,1,2,22,0,17,1,16,41,104,49,478,16,14,1000,560,519,41,2255
2022,33016 Castrillón,353,0,0,4,0,4,0,4,5,12,10,85,3,4,236,189,172,17,542
2022,33024 Gijón,6733,1,5,137,0,66,20,46,150,297,173,2404,73,44,3556,2466,2302,164,9199
2022,33031 Langreo,1135,1,0,18,0,8,1,7,29,56,40,184,4,10,825,318,272,46,1453
2022,33037 Mieres,976,0,0,28,0,6,3,3,26,45,31,234,19,9,609,290,241,49,1266
2022,33044 Oviedo,5195,1,4,110,0,60,6,54,92,255,199,1742,74,34,2823,2125,1895,230,7320
2022,33066 Siero,1550,0,0,18,0,10,4,6,19,106,68,521,19,5,852,370,321,49,1920
2022,BALEARS (ILLES),67281,3,36,1319,4,855,157,698,1272,2930,2174,24460,1564,627,34211,8701,7452,1249,75982
2022,Provincia de BALEARES,67281,3,36,1319,4,855,157,698,1272,2930,2174,24460,1564,627,34211,8701,7452,1249,75982
2022,07026 Eivissa,3759,0,2,55,0,41,11,30,99,173,96,1425,93,73,1798,565,528,37,4324
2022,07046 Sant Antoni de Portmany,2183,0,0,84,0,27,8,19,53,69,45,672,95,85,1098,169,136,33,2352
2022,07048 Sant Josep de sa Talaia,2827,1,2,62,0,35,8,27,41,156,124,1118,117,97,1198,200,178,22,3027
2022,07054 Santa Eulària des Riu,2002,0,0,49,0,29,6,23,25,118,86,571,74,22,1114,207,183,24,2209
2022,07003 Alcudia,1336,0,1,49,0,15,1,14,20,110,75,474,4,9,654,69,48,21,1405
2022,07011 Calvià,4997,0,1,100,0,72,16,56,148,194,168,2022,30,78,2352,308,267,41,5305
2022,07027 Inca,1224,0,1,50,0,28,3,25,28,79,69,215,13,3,807,86,61,25,1310
2022,07031 Llucmajor,1903,0,0,42,0,31,3,28,28,89,78,563,13,7,1130,238,193,45,2141
2022,07033 Manacor,1613,0,2,23,0,25,4,21,25,109,80,421,23,14,971,216,178,38,1829
2022,07036 Marratxí,1071,0,0,11,0,6,0,6,4,34,27,353,10,3,650,302,254,48,1373
2022,07040 Palma,29913,2,22,434,3,360,61,299,718,697,486,13020,926,155,13576,4808,4196,612,34721
2022,07015 Ciutadella de Menorca,1328,0,1,20,0,15,4,11,5,100,52,419,24,8,736,303,273,30,1631
2022,07032 Maó-Mahón,1265,0,0,30,0,17,5,12,7,36,15,220,10,20,925,102,89,13,1367
2022,CANARIAS,81767,13,47,1211,1,1051,234,817,1615,3679,2370,23596,1244,744,48566,13684,11699,1985,95451
2022,Provincia de PALMAS (LAS),44762,7,31,638,1,599,126,473,881,1856,1042,11697,713,483,27856,8054,6853,1201,52816
2022,35014 Oliva (La),1589,0,2,41,0,26,1,25,27,68,56,557,4,12,852,207,184,23,1796
2022,35015 Pájara,827,0,0,17,0,10,3,7,11,39,21,203,2,12,533,122,106,16,949
2022,35017 Puerto del Rosario,1675,0,2,38,0,19,7,12,23,55,37,447,52,9,1030,417,351,66,2092
2022,35002 Agüimes,1214,0,0,22,0,9,1,8,12,77,46,292,7,2,793,165,140,25,1379
2022,35006 Arucas,999,0,0,16,0,13,2,11,5,39,18,138,0,7,781,236,172,64,1235
2022,35009 Gáldar,647,0,1,8,0,9,0,9,6,20,11,95,1,4,503,112,101,11,759
2022,35011 Ingenio,832,0,0,10,0,11,3,8,4,37,18,135,8,2,625,148,134,14,980
2022,35012 Mogán,1459,0,0,17,0,25,7,18,18,67,46,527,10,19,776,85,72,13,1544
2022,35016 Palmas de Gran Canaria (Las),15983,1,7,145,1,195,47,148,475,547,308,4602,364,205,9441,3269,2786,483,19252
2022,35019 San Bartolomé de Tirajana,3766,0,1,50,0,42,5,37,83,109,59,1517,50,70,1844,311,279,32,4077
2022,35022 Santa Lucía de Tirajana,2426,0,6,58,0,30,6,24,42,56,43,562,14,9,1649,448,390,58,2874
2022,35026 Telde,4266,1,6,42,0,76,17,59,60,189,94,829,130,31,2902,1039,812,227,5305
2022,35004 Arrecife,2269,2,4,60,0,29,10,19,61,158,34,443,38,46,1428,209,190,19,2478
2022,35024 Teguise,506,0,0,9,0,8,2,6,5,33,11,76,1,14,360,128,117,11,634
2022,35028 Tías,1194,0,0,22,0,19,5,14,19,94,55,399,4,1,636,133,122,11,1327
2022,Provincia de SANTA CRUZ DE TENERIFE,37005,6,16,573,0,452,108,344,734,1823,1328,11899,531,261,20710,5630,4846,784,42635
2022,38024 Llanos de Aridane (Los),444,0,0,10,0,5,1,4,3,18,13,58,3,2,345,24,18,6,468
2022,38001 Adeje,4629,0,3,57,0,54,12,42,95,228,130,2221,70,48,1853,239,195,44,4868
2022,38006 Arona,5354,2,0,95,0,58,15,43,194,329,238,2158,70,38,2410,463,387,76,5817
2022,38011 Candelaria,468,0,1,7,0,8,0,8,4,27,22,79,0,2,340,159,136,23,627
2022,38017 Granadilla de Abona,2171,0,0,50,0,22,5,17,27,88,83,609,36,15,1324,308,254,54,2479
2022,38019 Guía de Isora,963,1,1,9,0,11,2,9,9,62,48,271,10,3,586,131,106,25,1094
2022,38020 Güímar,508,0,1,7,0,13,6,7,6,33,29,65,8,3,372,93,79,14,601
2022,38022 Icod de los Vinos,326,0,0,8,0,4,0,4,0,37,24,49,1,3,224,36,28,8,362
2022,38026 Orotava (La),1124,0,0,12,0,7,0,7,14,51,34,418,3,4,615,97,67,30,1221
2022,38028 Puerto de la Cruz,1622,0,0,25,0,16,4,12,33,58,49,668,17,5,800,201,174,27,1823
2022,38031 Realejos (Los),621,0,0,11,0,5,0,5,3,60,55,102,9,1,430,205,188,17,826
2022,38023 San Cristóbal de La Laguna,5060,0,5,74,0,56,14,42,134,182,124,1424,122,39,3024,1210,1092,118,6270
2022,38035 San Miguel de Abona,1232,0,0,18,0,14,3,11,19,118,108,410,24,4,625,213,187,26,1445
2022,38038 Santa Cruz de Tenerife,6873,2,2,95,0,83,25,58,154,222,154,2233,122,43,3917,1468,1289,179,8341
2022,38043 Tacoronte,533,0,0,8,0,5,0,5,7,42,32,85,5,2,379,85,73,12,618
2022,CANTABRIA,18903,1,11,374,0,140,39,101,242,1818,1348,4878,86,83,11270,4806,4349,457,23709
2022,Provincia de CANTABRIA,18903,1,11,374,0,140,39,101,242,1818,1348,4878,86,83,11270,4806,4349,457,23709
2022,39016 Camargo,1206,0,1,12,0,9,2,7,4,116,83,461,3,3,597,285,270,15,1491
2022,39020 Castro-Urdiales,1403,0,0,24,0,16,2,14,9,101,86,342,3,5,903,219,197,22,1622
2022,39052 Piélagos,576,0,1,8,0,5,1,4,0,76,63,85,5,2,394,241,224,17,817
2022,39075 Santander,5751,1,2,128,0,47,13,34,131,405,284,2154,36,34,2813,1668,1521,147,7419
2022,39087 Torrelavega,1689,0,0,33,0,15,5,10,32,164,104,447,15,10,973,424,401,23,2113
2022,CASTILLA Y LEON,65542,16,39,1038,3,535,107,428,710,4360,2966,17361,512,482,40486,21302,18968,2334,86844
2022,Provincia de ÁVILA,4058,1,1,90,0,39,9,30,25,294,229,690,13,27,2878,1218,1094,124,5276
2022,05019 Ávila,923,1,0,13,0,14,4,10,5,53,27,241,6,5,585,416,396,20,1339
2022,Provincia de BURGOS,10506,2,12,182,0,74,26,48,162,770,557,2851,83,93,6277,2822,2505,317,13328
2022,09018 Aranda de Duero,1238,0,3,16,0,8,4,4,21,48,36,377,8,7,750,346,296,50,1584
2022,09059 Burgos,4563,2,3,81,0,39,15,24,107,257,170,1721,47,51,2255,1490,1366,124,6053
2022,09219 Miranda de Ebro,1068,0,1,27,0,5,1,4,15,88,77,224,13,9,686,229,204,25,1297
2022,Provincia de LEÓN,12716,2,7,204,0,110,17,93,183,778,468,3529,112,72,7719,3757,3373,384,16473
2022,24089 León,4849,1,0,74,0,35,6,29,117,300,113,2038,56,20,2208,1395,1281,114,6244
2022,24115 Ponferrada,1619,0,1,25,0,21,4,17,24,103,74,476,16,12,941,628,548,80,2247
2022,24142 San Andrés del Rabanedo,756,0,2,6,0,5,1,4,12,36,28,175,13,4,503,293,257,36,1049
2022,Provincia de PALENCIA,3589,1,2,73,0,38,6,32,44,203,139,761,29,51,2387,1392,1274,118,4981
2022,34120 Palencia,1725,1,2,27,0,23,3,20,37,64,39,497,20,26,1028,562,528,34,2287
2022,Provincia de SALAMANCA,8829,0,7,112,0,55,18,37,95,624,430,2840,53,77,4966,3508,3002,506,12337
2022,37274 Salamanca,5066,0,6,43,0,28,11,17,81,310,231,2025,35,34,2504,1693,1400,293,6759
2022,Provincia de SEGOVIA,4074,0,2,65,0,45,12,33,25,283,233,949,37,31,2637,1300,1110,190,5374
2022,40194 Segovia,1344,0,0,16,0,15,4,11,14,30,21,506,7,8,748,339,313,26,1683
2022,Provincia de SORIA,2359,2,0,38,0,34,6,28,7,137,97,515,19,25,1582,1043,961,82,3402
2022,42173 Soria,1103,1,0,27,0,20,4,16,6,48,35,308,7,14,672,579,533,46,1682
2022,Provincia de VALLADOLID,15009,8,4,199,2,112,8,104,143,956,625,4145,129,60,9251,5284,4775,509,20293
2022,47010 Arroyo de la Encomienda,956,0,0,10,0,1,0,1,5,27,23,490,7,2,414,357,318,39,1313
2022,47076 Laguna de Duero,751,0,0,10,0,3,0,3,8,28,18,117,2,1,582,205,171,34,956
2022,47085 Medina del Campo,478,1,0,11,0,7,1,6,6,28,18,94,2,3,326,182,166,16,660
2022,47186 Valladolid,8401,4,3,100,0,76,4,72,110,521,333,2780,86,35,4686,2849,2631,218,11250
2022,Provincia de ZAMORA,4402,0,4,75,1,28,5,23,26,315,188,1081,37,46,2789,978,874,104,5380
2022,49275 Zamora,1594,0,1,19,0,10,3,7,13,112,77,516,29,24,870,483,441,42,2077
2022,CASTILLA - LA MANCHA,65193,19,47,981,2,550,116,434,899,4807,3307,14393,654,560,42281,15649,13608,2041,80842
2022,Provincia de ALBACETE,11993,2,12,165,0,115,30,85,204,723,563,3703,135,85,6849,3308,2966,342,15301
2022,02003 Albacete,6433,2,2,70,0,64,21,43,133,216,165,2577,92,30,3247,1714,1585,129,8147
2022,02009 Almansa,457,0,1,7,0,11,0,11,4,51,36,93,3,4,283,125,113,12,582
2022,02037 Hellín,1273,0,4,15,0,10,4,6,30,132,110,239,6,6,831,210,186,24,1483
2022,02081 Villarrobledo,877,0,0,15,0,5,1,4,16,59,40,323,3,17,439,251,211,40,1128
2022,Provincia de CIUDAD REAL,12657,5,14,215,1,108,28,80,200,871,573,2897,107,105,8134,3243,2880,363,15900
2022,13005 Alcázar de San Juan,793,0,1,10,0,11,2,9,7,55,22,199,17,6,487,279,256,23,1072
2022,13034 Ciudad Real,2533,0,0,31,0,20,6,14,73,117,62,922,27,14,1329,741,666,75,3274
2022,13071 Puertollano,1638,0,0,26,0,14,2,12,43,89,61,335,25,16,1090,270,238,32,1908
2022,13082 Tomelloso,972,1,0,32,0,14,4,10,26,63,49,191,3,13,629,122,109,13,1094
2022,13087 Valdepeñas,633,0,1,6,0,7,4,3,7,31,19,132,7,7,435,160,150,10,793
2022,Provincia de CUENCA,5459,2,5,112,0,56,17,39,47,439,263,1096,31,47,3624,1579,1411,168,7038
2022,16078 Cuenca,1982,1,3,31,0,22,10,12,33,170,67,489,9,4,1220,598,519,79,2580
2022,Provincia de GUADALAJARA,9929,3,4,126,1,83,12,71,161,688,446,1864,136,52,6811,1802,1551,251,11731
2022,19046 Azuqueca de Henares,1683,0,0,22,0,13,2,11,45,80,26,329,14,5,1175,215,172,43,1898
2022,19130 Guadalajara,2800,1,0,44,0,26,5,21,68,137,81,853,50,13,1608,624,562,62,3424
2022,Provincia de TOLEDO,25155,7,12,363,0,188,29,159,287,2086,1462,4833,245,271,16863,5717,4800,917,30872
2022,45081 Illescas,1499,0,0,20,0,8,1,7,31,108,78,372,19,12,929,237,206,31,1736
2022,45161 Seseña,1357,0,1,16,0,15,4,11,14,61,39,224,16,11,999,259,198,61,1616
2022,45165 Talavera de la Reina,2378,0,3,31,0,25,2,23,37,87,65,700,50,32,1413,245,204,41,2623
2022,45168 Toledo,2767,0,1,52,0,19,3,16,36,208,83,921,21,17,1492,648,600,48,3415
2022,CATALUÑA,411154,63,201,4015,9,3496,1184,2312,25049,27975,20019,162170,7411,3965,176800,63877,61607,2270,475031
2022,Provincia de BARCELONA,316672,36,137,2836,7,2511,846,1665,22457,19045,13395,133635,6171,2892,126945,46513,45021,1492,363185
2022,08015 Badalona,11727,1,9,120,0,100,39,61,1462,840,467,3825,251,51,5068,1978,1922,56,13705
2022,08252 Barberà del Vallès,1383,0,0,17,0,10,4,6,53,157,91,502,29,9,606,243,234,9,1626
2022,08019 Barcelona,151282,11,42,993,2,955,293,662,13234,6758,4861,79760,2871,1594,45062,16533,16113,420,167815
2022,08051 Castellar del Vallès,264,0,0,4,0,2,2,0,4,33,24,40,6,9,166,126,122,4,390
2022,08056 Castelldefels,2770,0,1,24,0,20,7,13,88,199,180,1073,48,16,1301,554,513,41,3324
2022,08266 Cerdanyola del Vallès,1607,0,1,18,0,23,6,17,85,148,111,455,38,6,833,401,381,20,2008
2022,08073 Cornellà de Llobregat,4329,0,8,68,0,50,19,31,358,210,124,1571,96,36,1932,794,771,23,5123
2022,08076 Esparreguera,350,2,2,9,0,6,1,5,10,36,24,69,10,2,204,136,127,9,486
2022,08077 Esplugues de Llobregat,3012,0,0,20,0,15,4,11,159,150,106,1397,55,7,1209,340,332,8,3352
2022,08086 Les Franqueses del Vallès,600,0,0,7,2,10,3,7,33,39,21,118,6,1,384,72,66,6,672
2022,08089 Gavà,1973,0,0,8,0,9,3,6,58,112,57,735,28,7,1016,502,492,10,2475
2022,08096 Granollers,2777,0,1,48,0,33,12,21,182,201,114,815,51,13,1433,308,297,11,3085
2022,08101 Hospitalet de Llobregat (L'),17990,3,10,177,0,130,44,86,1587,757,452,6374,319,109,8524,807,782,25,18797
2022,08102 Igualada,1462,0,0,23,0,23,12,11,51,123,82,498,31,8,705,402,377,25,1864
2022,08112 Manlleu,233,0,0,9,0,8,1,7,9,21,15,45,1,2,138,116,112,4,349
2022,08113 Manresa,3357,0,0,53,0,35,14,21,148,287,228,999,37,16,1782,795,767,28,4152
2022,08114 Martorell,1116,1,4,11,0,6,1,5,42,102,65,407,17,7,519,252,243,9,1368
2022,08118 Masnou (El),520,0,1,9,0,7,3,4,30,46,30,160,9,0,258,224,221,3,744
2022,08121 Mataró,7265,0,3,99,1,66,28,38,636,362,227,2283,199,37,3579,1329,1294,35,8594
2022,08123 Molins de Rei,811,0,0,17,0,11,5,6,36,115,73,240,25,6,361,225,222,3,1036
2022,08124 Mollet del Vallès,2346,0,2,20,0,17,10,7,89,116,89,680,33,11,1378,200,191,9,2546
2022,08125 Montcada i Reixac,2226,0,2,19,0,21,4,17,69,137,81,529,57,17,1375,302,296,6,2528
2022,08147 Olesa de Montserrat,342,1,0,4,1,7,2,5,6,31,21,69,8,9,206,125,121,4,467
2022,08163 Pineda de Mar,1304,1,0,25,0,13,5,8,46,129,105,364,21,14,691,326,307,19,1630
2022,08169 Prat de Llobregat (El),7768,0,1,33,0,30,9,21,166,87,44,4473,197,252,2529,525,509,16,8293
2022,08172 Premià de Mar,1193,1,1,13,0,12,1,11,69,74,57,282,29,2,710,318,311,7,1511
2022,08180 Ripollet,1261,0,1,14,0,6,2,4,46,75,46,331,50,5,733,241,238,3,1502
2022,08184 Rubí,3406,0,3,21,0,32,8,24,139,338,140,819,79,19,1956,519,504,15,3925
2022,08187 Sabadell,8074,0,3,71,0,93,32,61,483,510,369,2762,189,82,3881,1603,1564,39,9677
2022,08194 Sant Adrià de Besòs,3473,2,3,22,0,17,3,14,286,186,64,1229,65,36,1627,339,332,7,3812
2022,08196 Sant Andreu de la Barca,474,0,0,12,0,9,3,6,26,34,15,85,15,7,286,185,175,10,659
2022,08200 Sant Boi de Llobregat,3282,0,4,31,0,21,9,12,104,145,98,1238,64,19,1656,767,738,29,4049
2022,08205 Sant Cugat del Vallès,3975,0,1,28,0,37,7,30,154,345,296,1462,93,8,1847,612,582,30,4587
2022,08211 Sant Feliu de Llobregat,1252,0,0,13,0,17,4,13,57,158,110,361,42,2,602,433,415,18,1685
2022,08217 Sant Joan Despí,1026,0,0,12,0,11,4,7,61,101,71,316,32,6,487,276,267,9,1302
2022,08231 Sant Pere de Ribes,727,0,0,13,0,13,5,8,15,62,53,163,25,4,432,249,241,8,976
2022,08238 Sant Quirze del Vallès,620,0,0,10,0,9,5,4,48,42,27,243,5,0,263,106,104,2,726
2022,08263 Sant Vicenç dels Horts,1021,0,0,17,0,19,12,7,37,82,55,265,33,7,561,241,231,10,1262
2022,08245 Santa Coloma de Gramenet,4509,5,3,43,0,55,14,41,479,219,153,1541,67,10,2087,634,616,18,5143
2022,08260 Santa Perpètua de Mogoda,1033,1,1,10,0,13,6,7,28,93,57,266,17,26,578,220,211,9,1253
2022,08270 Sitges,2536,0,0,28,0,23,11,12,133,186,168,1111,28,10,1017,304,289,15,2840
2022,08279 Terrassa,8442,2,7,84,0,79,33,46,401,610,376,2481,164,37,4577,1304,1269,35,9746
2022,08298 Vic,1860,0,0,28,0,22,6,16,45,149,96,726,22,12,856,438,417,21,2298
2022,08301 Viladecans,2580,0,0,18,0,26,8,18,98,119,78,1178,44,4,1093,576,564,12,3156
2022,08305 Vilafranca del Penedès,2025,0,0,33,0,19,6,13,130,129,81,735,63,8,908,341,331,10,2366
2022,08307 Vilanova i la Geltrú,3272,0,4,40,0,28,7,21,186,208,124,1104,58,15,1629,657,628,29,3929
2022,08219 Vilassar de Mar,465,0,0,2,0,7,2,5,22,63,54,134,14,3,220,168,164,4,633
2022,Provincia de GIRONA,40155,10,15,492,0,363,108,255,1012,3798,2728,13317,585,450,20113,7118,6833,285,47273
2022,17015 Banyoles,892,0,0,11,0,5,0,5,16,45,38,281,11,7,516,194,191,3,1086
2022,17023 Blanes,2033,1,0,27,0,18,5,13,58,119,88,728,41,8,1033,252,229,23,2285
2022,17066 Figueres,3163,1,1,39,0,34,10,24,99,189,86,1023,48,47,1682,423,403,20,3586
2022,17079 Girona,5666,0,3,70,0,57,16,41,283,431,256,2220,97,39,2466,1163,1123,40,6829
2022,17095 Lloret de Mar,2803,2,0,38,0,29,12,17,106,222,205,1241,33,28,1104,332,316,16,3135
2022,17114 Olot,1131,0,1,22,0,20,6,14,27,155,107,291,29,2,584,332,320,12,1463
2022,17117 Palafrugell,835,0,1,11,0,7,3,4,11,55,39,278,17,3,452,201,196,5,1036
2022,17155 Salt,2025,0,0,13,0,16,4,12,81,60,41,792,26,5,1032,284,275,9,2309
2022,17160 Sant Feliu de Guíxols,1057,0,1,8,0,4,1,3,19,113,71,304,20,14,574,219,207,12,1276
2022,Provincia de LLEIDA,17549,7,12,306,0,197,77,120,479,1316,936,5022,165,154,9891,4071,3847,224,21620
2022,25120 Lleida,8366,3,5,85,0,82,37,45,384,465,348,3162,69,44,4067,1457,1364,93,9823
2022,Provincia de TARRAGONA,36778,10,37,381,2,425,153,272,1101,3816,2960,10196,490,469,19851,6175,5906,269,42953
2022,43014 Amposta,869,0,3,7,0,13,8,5,12,71,38,277,6,13,467,132,127,5,1001
2022,43037 Calafell,1095,0,3,17,1,21,6,15,49,116,104,289,16,17,566,173,164,9,1268
2022,43038 Cambrils,1379,0,2,13,0,18,7,11,24,211,193,373,14,18,706,323,299,24,1702
2022,43123 Reus,4251,1,3,47,1,67,23,44,184,478,318,1091,91,46,2242,892,864,28,5143
2022,43905 Salou,3345,2,3,26,0,33,11,22,112,244,195,1101,37,37,1750,246,236,10,3591
2022,43148 Tarragona,7437,1,6,67,0,68,25,43,290,432,282,2897,105,49,3522,865,825,40,8302
2022,43155 Tortosa,1334,2,1,10,0,13,4,9,48,121,98,331,8,13,787,414,393,21,1748
2022,43161 Valls,1318,0,1,10,0,12,5,7,58,215,162,281,26,16,699,200,195,5,1518
2022,43163 Vendrell (El),2297,0,2,30,0,28,8,20,127,193,156,576,36,27,1278,407,391,16,2704
2022,43171 Vila-seca,1388,0,0,4,0,8,4,4,18,102,76,440,16,14,786,170,162,8,1558
2022,COMUNITAT VALENCIANA,228966,38,137,3284,10,2197,513,1684,5663,18032,14601,71315,3160,2034,123096,34005,29040,4965,262971
2022,Provincia de ALICANTE/ALACANT,81265,12,52,1141,5,896,244,652,1582,7050,5975,24274,1181,963,44109,13075,11280,1795,94340
2022,03009 Alcoy/Alcoi,1501,2,2,16,0,28,13,15,29,124,106,382,25,8,885,542,465,77,2043
2022,03011 L'Alfàs del Pi,940,0,0,12,0,6,2,4,13,94,80,366,19,4,426,78,70,8,1018
2022,03014 Alicante/Alacant,17719,1,20,209,0,217,57,160,532,726,564,6434,333,334,8913,3485,2958,527,21204
2022,03015 Almoradí,893,0,0,12,0,12,2,10,23,45,38,196,5,12,588,129,110,19,1022
2022,03018 Altea,1303,0,0,10,0,6,2,4,25,205,178,350,14,6,687,107,94,13,1410
2022,03019 Aspe,574,0,0,6,0,3,1,2,5,71,65,98,3,5,383,90,68,22,664
2022,03031 Benidorm,4571,2,1,130,1,49,21,28,99,164,102,1855,53,116,2101,639,574,65,5210
2022,03047 Calp,1309,0,1,19,0,12,1,11,17,123,115,378,5,5,749,226,202,24,1535
2022,03050 Campello (el),1066,0,0,8,1,6,0,6,6,113,105,270,5,8,649,226,207,19,1292
2022,03059 Crevillent,795,0,0,14,0,16,3,13,5,42,32,160,3,12,543,128,109,19,923
2022,03063 Dénia,2141,0,3,44,0,30,10,20,28,235,223,523,57,15,1206,394,350,44,2535
2022,03065 Elche/Elx,7656,4,0,81,0,86,30,56,141,503,392,2474,149,128,4090,1397,1199,198,9053
2022,03066 Elda,1565,0,7,36,0,28,2,26,39,112,70,435,27,34,847,376,319,57,1941
2022,03079 Ibi,708,0,0,8,0,11,0,11,3,38,22,176,3,2,467,171,148,23,879
2022,03082 Jávea/Xàbia,1675,0,0,32,0,9,4,5,38,314,283,421,31,8,822,171,150,21,1846
2022,03090 Mutxamel,602,0,0,9,0,3,0,3,2,70,61,88,10,10,410,158,134,24,760
2022,03093 Novelda,613,0,1,13,0,14,4,10,6,56,45,109,3,0,411,49,41,8,662
2022,03099 Orihuela,3874,1,5,52,0,26,9,17,58,613,557,1114,68,39,1898,373,328,45,4247
2022,03104 Petrer,761,0,1,10,0,7,3,4,26,86,66,244,14,11,362,216,184,32,977
2022,03902 Pilar de la Horadada,1476,0,1,21,0,15,4,11,21,199,168,500,16,9,694,118,101,17,1594
2022,03122 San Vicente del Raspeig/Sant Vicent del Raspeig,1937,0,1,25,1,44,14,30,40,90,75,577,22,9,1128,320,262,58,2257
2022,03119 Sant Joan d'Alacant,878,0,0,13,0,7,3,4,4,51,40,281,6,3,513,185,162,23,1063
2022,03121 Santa Pola,1678,0,0,18,0,27,10,17,19,124,92,521,19,4,946,363,325,38,2041
2022,03133 Torrevieja,7371,0,2,104,1,74,19,55,160,611,537,2150,108,48,4113,486,418,68,7857
2022,03139 Villajoyosa/Vila Joiosa (la),1704,0,0,18,0,14,4,10,22,74,60,452,12,13,1099,202,183,19,1906
2022,03140 Villena,963,0,0,17,0,11,1,10,19,59,48,237,4,15,601,218,191,27,1181
2022,Provincia de CASTELLÓN/CASTELLÓ,23121,3,15,449,1,241,49,192,409,2153,1701,6361,235,121,13133,2576,2137,439,25697
2022,12009 Almazora/Almassora,1197,0,1,15,0,10,3,7,16,109,90,225,22,8,791,110,88,22,1307
2022,12027 Benicarló,1532,0,1,25,0,12,3,9,30,121,106,472,4,8,859,124,101,23,1656
2022,12032 Borriana/Burriana,2150,0,1,67,1,31,3,28,45,135,106,622,6,11,1231,127,106,21,2277
2022,12040 Castellón de la Plana/Castelló de la Plana,5435,2,3,87,0,68,13,55,160,519,381,1951,96,40,2509,850,737,113,6285
2022,12084 Onda,938,0,0,30,0,10,3,7,8,76,58,150,8,10,646,132,113,19,1070
2022,12126 Vall d'Uixó (la),1056,0,1,30,0,5,1,4,12,105,82,202,2,2,697,102,81,21,1158
2022,12135 Vila-real,1240,0,1,19,0,8,2,6,11,141,103,345,39,3,673,244,222,22,1484
2022,12138 Vinaròs,1475,1,1,32,0,13,2,11,18,165,139,365,6,4,870,120,86,34,1595
2022,Provincia de VALENCIA/VALÈNCIA,124580,23,70,1694,4,1060,220,840,3672,8829,6925,40680,1744,950,65854,18354,15623,2731,142934
2022,46005 Alaquàs,867,0,0,14,0,5,1,4,21,62,37,238,14,7,506,121,101,20,988
2022,46013 Alboraia/Alboraya,1316,0,0,7,0,5,0,5,35,78,43,529,30,5,627,142,123,19,1458
2022,46021 Aldaia,1666,0,0,12,0,3,0,3,19,45,28,995,13,5,574,130,112,18,1796
2022,46022 Alfafar,1566,0,0,20,0,11,2,9,47,48,34,503,25,8,904,196,165,31,1762
2022,46029 Algemesí,870,0,2,8,0,7,1,6,17,93,83,237,6,5,495,203,186,17,1073
2022,46017 Alzira,1858,1,1,26,0,9,4,5,39,191,165,472,22,9,1088,372,323,49,2230
2022,46070 Bétera,826,0,0,12,0,8,4,4,22,111,105,137,8,2,526,189,162,27,1015
2022,46078 Burjassot,1454,0,2,5,0,12,6,6,34,60,42,523,23,6,789,311,262,49,1765
2022,46083 Carcaixent,857,0,0,12,1,9,1,8,14,63,58,251,5,6,496,157,121,36,1014
2022,46094 Catarroja,865,0,0,8,0,7,1,6,25,72,48,193,17,3,540,178,144,34,1043
2022,46105 Cullera,1957,1,0,33,0,14,3,11,62,85,76,780,17,15,950,188,160,28,2145
2022,46131 Gandia,3880,1,1,60,0,40,5,35,82,246,193,1094,96,36,2224,504,459,45,4384
2022,46147 Llíria,1155,1,2,20,0,5,2,3,19,149,136,239,3,8,709,125,96,29,1280
2022,46159 Manises,1229,1,0,14,0,5,0,5,22,60,37,387,58,33,649,200,183,17,1429
2022,46169 Mislata,1099,0,3,13,0,11,4,7,30,52,46,317,14,7,652,389,349,40,1488
2022,46171 Moncada,756,0,0,5,0,7,2,5,9,70,58,162,5,0,498,129,109,20,885
2022,46181 Oliva,1084,0,2,19,0,13,1,12,14,87,81,210,13,11,715,151,124,27,1235
2022,46184 Ontinyent,710,0,0,10,0,13,6,7,8,93,88,142,11,10,423,223,204,19,933
2022,46186 Paiporta,794,0,0,14,0,21,0,21,25,65,40,163,11,5,490,151,123,28,945
2022,46190 Paterna,2318,1,3,29,1,23,5,18,54,209,167,559,53,21,1365,618,550,68,2936
2022,46194 Picassent,929,0,0,15,0,10,1,9,10,111,96,158,3,54,568,112,71,41,1041
2022,46202 Pobla de Vallbona (la),957,0,0,17,0,14,4,10,15,149,131,184,7,6,565,145,118,27,1102
2022,46205 Puçol,533,0,1,9,0,10,1,9,6,42,36,128,6,6,325,55,40,15,588
2022,46102 Quart de Poblet,870,0,0,6,0,3,1,2,24,35,17,226,28,1,547,157,139,18,1027
2022,46213 Requena,873,0,0,23,0,15,4,11,8,79,62,157,1,1,589,127,102,25,1000
2022,46214 Riba-roja de Túria,1192,0,0,20,0,4,1,3,12,109,85,307,12,15,713,175,140,35,1367
2022,46220 Sagunto/Sagunt,3060,0,1,47,1,33,4,29,61,197,163,907,52,22,1739,248,174,74,3308
2022,46235 Sueca,1342,1,1,33,0,16,7,9,16,101,88,291,6,6,871,198,166,32,1540
2022,46244 Torrent,3306,2,6,33,0,26,8,18,84,295,218,948,36,32,1844,560,460,100,3866
2022,46250 Valencia,54004,7,30,606,1,424,95,329,2385,2510,1800,23247,814,404,23576,6815,5927,888,60819
2022,46145 Xàtiva,1107,0,1,14,0,17,2,15,14,90,67,368,16,3,584,180,151,29,1287
2022,46110 Xirivella,916,0,1,11,0,7,1,6,20,42,36,268,13,5,549,150,124,26,1066
2022,EXTREMADURA,24565,3,7,379,1,260,51,209,296,1839,1198,6388,163,265,14964,7528,6577,951,32093
2022,Provincia de BADAJOZ,16254,1,6,253,0,166,31,135,205,1330,864,4506,112,181,9494,5087,4423,664,21341
2022,06011 Almendralejo,937,0,0,18,0,10,3,7,8,32,19,235,19,7,608,313,282,31,1250
2022,06015 Badajoz,5736,0,2,59,0,61,12,49,102,508,304,1825,50,73,3056,1651,1381,270,7387
2022,06044 Don Benito,996,0,2,12,0,14,1,13,15,77,45,262,7,5,602,334,295,39,1330
2022,06083 Mérida,2035,1,1,16,0,12,1,11,30,110,69,661,15,28,1161,616,551,65,2651
2022,06153 Villanueva de la Serena,609,0,0,8,0,7,0,7,7,43,29,161,4,12,367,198,174,24,807
2022,Provincia de CÁCERES,8311,2,1,126,1,94,20,74,91,509,334,1882,51,84,5470,2441,2154,287,10752
2022,10037 Cáceres,2261,0,1,29,0,31,8,23,50,104,54,727,14,15,1290,973,890,83,3234
2022,10148 Plasencia,1296,1,0,14,0,8,2,6,23,61,30,396,14,10,769,442,397,45,1738
2022,GALICIA,73990,7,45,1187,2,649,155,494,963,4127,2690,19527,528,505,46450,20914,18456,2458,94904
2022,Provincia de CORUÑA (A),34246,1,22,467,2,264,73,191,458,1873,1232,9631,167,162,21199,8437,7434,1003,42683
2022,15002 Ames,702,0,0,12,0,10,3,7,6,32,25,95,4,5,538,302,263,39,1004
2022,15005 Arteixo,1031,0,0,11,0,4,1,3,7,37,32,166,8,3,795,251,222,29,1282
2022,15017 Cambre,655,0,1,13,0,3,2,1,2,40,25,95,5,0,496,131,110,21,786
2022,15019 Carballo,1135,0,0,16,0,14,2,12,10,132,102,193,7,1,762,171,145,26,1306
2022,15030 Coruña (A),10378,1,13,77,1,58,9,49,240,436,233,4533,38,42,4939,2496,2247,249,12874
2022,15031 Culleredo,934,0,0,16,0,3,0,3,8,62,39,242,10,1,592,298,267,31,1232
2022,15036 Ferrol,2530,0,0,24,1,20,10,10,42,118,82,719,10,20,1576,578,491,87,3108
2022,15054 Narón,1014,0,0,4,0,13,5,8,12,69,47,269,9,7,631,351,310,41,1365
2022,15058 Oleiros,1107,0,0,14,0,9,3,6,10,109,98,256,8,2,699,352,317,35,1459
2022,15073 Ribeira,1117,0,3,22,0,7,3,4,10,48,31,216,4,8,799,147,115,32,1264
2022,15078 Santiago de Compostela,3718,0,2,44,0,31,11,20,44,153,79,1303,16,28,2097,876,794,82,4594
2022,Provincia de LUGO,6336,1,3,124,0,62,12,50,86,272,175,1460,23,46,4259,1931,1771,160,8267
2022,27028 Lugo,2627,1,1,55,0,24,7,17,61,112,63,868,9,24,1472,995,945,50,3622
2022,Provincia de OURENSE,6854,0,9,124,0,97,24,73,114,511,305,1742,51,46,4160,2511,2217,294,9365
2022,32054 Ourense,3411,0,3,61,0,51,18,33,84,190,102,1108,28,18,1868,1090,952,138,4501
2022,Provincia de PONTEVEDRA,26554,5,11,472,0,226,46,180,305,1471,978,6694,287,251,16832,8035,7034,1001,34589
2022,36008 Cangas,822,0,1,19,0,7,3,4,5,27,18,186,7,3,567,330,282,48,1152
2022,36017 Estrada (A),274,0,0,8,0,3,2,1,1,6,5,43,6,1,206,157,148,9,431
2022,36024 Lalín,329,0,0,12,0,2,2,0,2,27,16,52,0,2,232,139,121,18,468
2022,36026 Marín,466,0,0,8,0,4,1,3,2,14,8,84,6,7,341,174,160,14,640
2022,36042 Ponteareas,679,0,1,20,0,3,0,3,4,82,55,126,2,5,436,197,177,20,876
2022,36038 Pontevedra,2223,0,0,26,0,26,3,23,20,105,63,699,6,42,1299,832,767,65,3055
2022,"36039 Porriño, O",530,0,2,4,0,5,1,4,3,57,29,95,3,6,355,205,192,13,735
2022,36045 Redondela,805,0,0,4,0,6,3,3,7,44,29,105,9,2,628,97,72,25,902
2022,36057 Vigo,10227,3,4,127,0,95,17,78,193,483,304,3288,182,79,5773,2229,1866,363,12456
2022,36060 Vilagarcía de Arousa,1504,0,0,19,0,12,6,6,23,54,37,426,8,9,953,359,321,38,1863
2022,MADRID (COMUNIDAD DE),338166,46,137,3162,14,2459,613,1846,12626,13754,9518,132920,7397,2984,162667,63758,57794,5964,401924
2022,Provincia de MADRID,338166,46,137,3162,14,2459,613,1846,12626,13754,9518,132920,7397,2984,162667,63758,57794,5964,401924
2022,28005 Alcalá de Henares,8108,1,6,85,0,55,16,39,210,363,163,2708,229,42,4409,2212,1919,293,10320
2022,28006 Alcobendas,4145,0,1,37,0,24,12,12,94,186,111,1241,238,31,2293,1038,965,73,5183
2022,28007 Alcorcón,6202,2,2,31,1,45,6,39,194,253,172,2567,98,30,2979,1567,1356,211,7769
2022,28009 Algete,676,0,0,1,0,5,1,4,9,61,42,163,10,3,424,207,192,15,883
2022,28013 Aranjuez,2367,0,2,15,0,12,0,12,41,93,63,715,44,16,1429,491,457,34,2858
2022,28014 Arganda del Rey,2547,0,1,53,2,13,1,12,92,108,59,755,24,13,1486,416,352,64,2963
2022,28015 Arroyomolinos,2475,0,1,16,0,13,3,10,36,68,58,1276,46,3,1016,314,276,38,2789
2022,28022 Boadilla del Monte,1752,0,0,17,0,20,3,17,26,150,143,471,11,3,1054,511,456,55,2263
2022,28040 Ciempozuelos,1216,1,2,22,0,14,2,12,32,73,45,255,25,7,785,165,130,35,1381
2022,28047 Collado Villalba,2512,0,0,46,1,29,6,23,80,143,102,739,17,16,1441,578,506,72,3090
2022,28045 Colmenar Viejo,1563,0,1,23,0,7,0,7,21,84,68,356,10,4,1057,364,340,24,1927
2022,28049 Coslada,2972,0,2,22,0,21,3,18,76,156,83,901,108,18,1668,615,556,59,3587
2022,28058 Fuenlabrada,5091,1,0,29,0,29,11,18,201,231,144,1656,228,49,2667,1118,1063,55,6209
2022,28061 Galapagar,1272,0,0,35,0,19,1,18,18,90,86,195,4,6,905,367,309,58,1639
2022,28065 Getafe,7131,0,1,27,0,51,12,39,281,234,158,2503,253,29,3752,1355,1259,96,8486
2022,28074 Leganés,7617,0,0,67,0,52,19,33,196,315,189,3266,217,57,3447,1424,1280,144,9041
2022,28079 Madrid,207969,26,86,1752,5,1436,375,1061,8917,7139,4890,91657,4462,2214,90275,34886,32003,2883,242855
2022,28080 Majadahonda,4045,0,1,47,0,31,0,31,52,223,146,1464,146,7,2074,538,482,56,4583
2022,28084 Mejorada del Campo,1126,0,0,16,0,10,1,9,15,45,26,200,29,4,807,240,198,42,1366
2022,28092 Móstoles,6369,2,3,49,1,62,25,37,253,351,265,1731,188,46,3683,2043,1845,198,8412
2022,28096 Navalcarnero,1166,0,2,10,0,8,3,5,27,82,62,240,40,14,743,334,287,47,1500
2022,28104 Paracuellos de Jarama,761,0,0,8,0,10,0,10,15,46,33,177,24,3,478,199,175,24,960
2022,28106 Parla,5626,1,2,42,1,47,11,36,381,198,112,1557,90,17,3290,658,613,45,6284
2022,28113 Pinto,2425,0,1,24,0,25,3,22,64,128,105,871,23,20,1269,473,415,58,2898
2022,28115 Pozuelo de Alarcón,2233,1,1,20,1,12,4,8,55,81,70,913,78,9,1062,333,305,28,2566
2022,28123 Rivas-Vaciamadrid,4580,1,1,68,0,20,3,17,154,236,154,1674,42,21,2363,849,772,77,5429
2022,28127 Rozas de Madrid (Las),3513,1,2,54,0,32,6,26,84,163,142,1255,43,14,1865,899,823,76,4412
2022,28130 San Fernando de Henares,1596,0,0,9,0,6,2,4,52,61,34,475,57,20,916,286,260,26,1882
2022,28134 San Sebastián de los Reyes,3475,0,0,23,0,31,9,22,74,156,99,1535,86,34,1536,726,673,53,4201
2022,28148 Torrejón de Ardoz,4759,7,9,55,0,47,21,26,113,121,74,1664,107,64,2572,880,810,70,5639
2022,28152 Torrelodones,893,0,1,13,0,4,2,2,30,75,66,286,6,1,477,273,227,46,1166
2022,28903 Tres Cantos,1150,0,0,22,0,8,4,4,35,65,50,426,8,1,585,326,310,16,1476
2022,28161 Valdemoro,3001,0,1,65,0,27,4,23,77,119,72,830,46,18,1818,749,643,106,3750
2022,28176 Villanueva de la Cañada,948,0,1,4,0,11,1,10,15,68,63,320,6,3,520,190,166,24,1138
2022,28181 Villaviciosa de Odón,1137,0,0,8,0,13,7,6,49,100,82,320,8,4,635,267,225,42,1404
2022,MURCIA (REGION DE),58746,8,51,1156,6,577,93,484,1999,5364,4001,15475,774,527,32809,9971,8651,1320,68717
2022,Provincia de MURCIA,58746,8,51,1156,6,577,93,484,1999,5364,4001,15475,774,527,32809,9971,8651,1320,68717
2022,30003 Águilas,1691,0,1,11,0,9,0,9,57,149,121,417,12,17,1018,241,188,53,1932
2022,30005 Alcantarilla,1285,0,2,33,0,17,4,13,39,60,50,322,34,25,753,354,303,51,1639
2022,30008 Alhama de Murcia,856,0,0,18,0,12,2,10,23,53,48,149,5,6,590,149,128,21,1005
2022,30015 Caravaca de la Cruz,713,0,0,17,0,6,2,4,7,76,60,134,9,6,458,175,157,18,888
2022,30016 Cartagena,7856,0,3,127,0,64,10,54,212,625,438,2328,89,59,4349,1520,1352,168,9376
2022,30019 Cieza,1276,0,0,24,0,19,2,17,24,97,81,249,13,6,844,186,160,26,1462
2022,30022 Jumilla,1203,0,0,29,0,12,2,10,30,123,85,237,4,5,763,152,136,16,1355
2022,30024 Lorca,2568,0,3,55,0,23,1,22,102,205,150,603,20,13,1544,449,412,37,3017
2022,30026 Mazarrón,1570,2,1,38,0,21,3,18,36,190,167,356,8,8,910,199,159,40,1769
2022,30027 Molina de Segura,2015,0,5,32,1,20,5,15,88,199,168,562,52,28,1028,529,496,33,2544
2022,30030 Murcia,20816,0,26,377,3,183,27,156,1016,1778,1190,6331,348,237,10517,3227,2782,445,24043
2022,30035 San Javier,2090,0,0,38,0,23,4,19,44,217,162,711,14,8,1035,300,273,27,2390
2022,30036 San Pedro del Pinatar,1252,0,1,18,0,15,4,11,23,130,100,412,5,4,644,162,145,17,1414
2022,30037 Torre-Pacheco,1409,0,1,22,1,21,2,19,34,194,95,250,20,6,860,220,183,37,1629
2022,30038 Torres de Cotillas (Las),840,0,0,15,0,6,0,6,20,78,65,158,7,11,545,139,110,29,979
2022,30039 Totana,1031,1,1,82,0,28,8,20,49,78,67,212,11,4,565,212,157,55,1243
2022,30041 La Unión,586,1,2,5,0,7,0,7,9,34,24,131,1,3,393,105,91,14,691
2022,30043 Yecla,819,0,0,15,0,9,1,8,7,92,83,125,10,7,554,179,156,23,998
2022,NAVARRA (COMUNIDAD FORAL DE),27910,3,21,404,2,321,76,245,422,1464,985,8108,132,147,16886,5499,4816,683,33409
2022,Provincia de NAVARRA,27910,3,21,404,2,321,76,245,422,1464,985,8108,132,147,16886,5499,4816,683,33409
2022,31060 Burlada/Burlata,555,0,1,7,0,11,4,7,8,22,17,107,1,3,395,118,100,18,673
2022,31201 Pamplona/Iruña,13004,0,4,126,0,154,34,120,299,445,284,5257,46,83,6590,1826,1590,236,14830
2022,31232 Tudela,2162,2,5,36,0,23,3,20,39,152,112,539,11,16,1339,243,213,30,2405
2022,31086 Valle de Egüés/Eguesibar,476,0,0,6,0,5,1,4,1,53,38,87,3,0,321,158,130,28,634
2022,PAÍS VASCO,80849,8,63,1534,4,756,235,521,2201,7581,5113,29230,718,623,38131,20907,18861,2046,101756
2022,Provincia de ARABA/ÁLAVA,10479,0,3,228,0,120,30,90,114,830,568,3850,56,105,5173,3561,3186,375,14040
2022,01059 Vitoria-Gasteiz,7879,0,2,176,0,98,26,72,98,469,298,3295,28,89,3624,2765,2489,276,10644
2022,Provincia de GIPUZKOA,22948,3,30,552,1,258,82,176,399,2771,1675,6378,228,284,12044,6069,5572,497,29017
2022,20055 Arrasate/Mondragón,428,0,1,7,0,5,0,5,2,46,17,107,4,5,251,221,210,11,649
2022,20069 Donostia/San Sebastián,6588,1,13,207,1,85,22,63,181,627,424,2176,40,68,3189,1454,1322,132,8042
2022,20030 Eibar,1085,0,0,27,0,13,7,6,13,140,68,264,8,16,604,258,232,26,1343
2022,20067 Errenteria,1086,0,1,21,0,7,2,5,25,90,69,262,15,22,643,349,331,18,1435
2022,20040 Hernani,640,0,0,11,0,10,3,7,4,86,45,175,13,3,338,124,104,20,764
2022,20045 Irun,3066,1,8,64,0,43,18,25,71,253,149,842,45,60,1679,724,667,57,3790
2022,20079 Zarautz,660,0,0,22,0,4,3,1,5,63,32,230,5,3,328,225,219,6,885
2022,Provincia de BIZKAIA,47422,5,30,754,3,378,123,255,1688,3980,2870,19002,434,234,20914,11277,10103,1174,58699
2022,48013 Barakaldo,4582,2,3,55,0,35,8,27,145,327,233,1640,54,22,2299,865,770,95,5447
2022,48015 Basauri,1504,0,1,19,0,4,0,4,38,76,42,602,8,10,746,409,356,53,1913
2022,48020 Bilbao,20033,1,12,290,1,157,59,98,1025,782,466,11189,132,50,6394,3664,3335,329,23697
2022,48027 Durango,904,0,2,22,0,11,2,9,44,82,63,344,4,10,385,292,273,19,1196
2022,48902 Erandio,1253,1,1,32,0,12,1,11,71,82,65,362,11,2,679,265,226,39,1518
2022,48036 Galdakao,925,0,0,19,0,3,2,1,18,138,108,227,9,6,505,288,255,33,1213
2022,48044 Getxo,2008,1,4,56,0,15,1,14,69,293,274,615,11,4,940,711,644,67,2719
2022,48054 Leioa,936,0,0,10,0,9,4,5,30,164,142,288,16,6,413,300,269,31,1236
2022,48078 Portugalete,1815,0,2,13,0,14,6,8,40,133,93,803,16,9,785,334,298,36,2149
2022,48082 Santurtzi,1121,0,2,20,0,10,7,3,26,91,69,313,5,8,646,430,389,41,1551
2022,48084 Sestao,959,0,0,9,0,11,3,8,26,57,33,278,9,9,560,276,241,35,1235
2022,RIOJA (LA),9321,1,8,198,0,101,19,82,121,713,527,2743,77,98,5261,2433,2152,281,11754
2022,Provincia de LA RIOJA,9321,1,8,198,0,101,19,82,121,713,527,2743,77,98,5261,2433,2152,281,11754
2022,26036 Calahorra,1041,0,1,33,0,16,3,13,14,75,46,287,3,4,608,218,184,34,1259
2022,26089 Logroño,4341,0,4,84,0,48,10,38,74,264,203,1725,58,54,2030,885,801,84,5226
2022,CIUDAD AUTÓNOMA DE CEUTA,3068,4,31,75,1,42,5,37,107,45,31,425,107,115,2116,567,469,98,3635
2022,51001 Ceuta,3068,4,31,75,1,42,5,37,107,45,31,425,107,115,2116,567,469,98,3635
2022,CIUDAD AUTÓNOMA DE MELILLA,3904,2,5,102,0,22,4,18,121,87,46,732,78,69,2686,405,329,76,4309
2022,52001 Melilla,3904,2,5,102,0,22,4,18,121,87,46,732,78,69,2686,405,329,76,4309
2022,NACIONAL,1948338,326,1213,26444,84,17367,4270,13097,63392,121039,86515,642276,30767,19057,1026373,374737,335995,38742,2323075
