Fecha,Lugar,I. CRIMINALIDAD CONVENCIONAL,1. Homicidios dolosos y asesinatos consumados,2. Homicidios dolosos y asesinatos en grado tentativa,3. Delitos graves y menos graves de lesiones y riña tumultuaria,4. Secuestro,5. Delitos contra la libertad sexual,5.1.-Agresión sexual con penetración,5.2.-Resto de delitos contra la libertad sexual,6. Robos con violencia e intimidación,"7. Robos con fuerza en domicilios, establecimientos y otras instalaciones",7.1.-Robos con fuerza en domicilios,8. Hurtos,9. Sustracciones de vehículos,10. Tráfico de drogas,11. Resto de criminalidad convencional,II. CIBERCRIMINALIDAD (infracciones penales cometidas en/por medio ciber),12.-Estafas informáticas,13.-Otros ciberdelitos,III. TOTAL INFRACCIONES PENALES
2023,ANDALUCÍA,331854,71,292,5021,34,3066,602,2464,7676,20294,14101,95492,5957,4790,189161,81327,72795,8532,413181
2023,Provincia de ALMERÍA,28314,8,29,540,3,360,78,282,657,2019,1602,6437,349,467,17445,4977,4414,563,33291
2023,04003 Adra,953,0,1,11,1,9,3,6,19,73,62,216,7,12,604,140,114,26,1093
2023,04013 Almería,7463,1,13,114,1,97,21,76,245,327,252,2144,143,193,4185,1611,1480,131,9074
2023,04902 Ejido (El),3785,3,5,93,0,40,13,27,62,225,165,796,47,80,2434,453,407,46,4238
2023,04053 Huércal-Overa,587,0,0,8,0,9,2,7,9,93,78,123,6,1,338,117,105,12,704
2023,04066 Níjar,1415,0,0,50,0,18,2,16,32,85,51,182,9,20,1019,173,157,16,1588
2023,04079 Roquetas de Mar,5722,1,1,94,0,62,14,48,198,367,317,1547,50,51,3351,744,648,96,6466
2023,04102 Vícar,1405,1,0,23,0,15,4,11,21,86,67,287,8,28,936,171,140,31,1576
2023,Provincia de CÁDIZ,47036,12,51,731,2,412,68,344,876,2581,1601,12826,994,789,27762,12871,11370,1501,59907
2023,11004 Algeciras,4982,1,7,135,0,53,6,47,81,173,99,958,107,185,3282,913,800,113,5895
2023,11006 Arcos de la Frontera,740,0,1,11,1,15,4,11,8,72,50,151,16,11,454,118,94,24,858
2023,11007 Barbate,1130,1,1,17,0,12,1,11,13,75,49,236,5,12,758,156,142,14,1286
2023,11008 Barrios (Los),1068,1,1,10,0,4,3,1,10,33,16,267,14,7,721,264,238,26,1332
2023,11012 Cádiz,4290,0,5,30,0,37,5,32,102,193,84,1707,106,57,2053,1613,1374,239,5903
2023,11015 Chiclana de la Frontera,3167,1,1,42,0,34,4,30,36,319,228,714,96,35,1889,1014,888,126,4181
2023,11014 Conil de la Frontera,1105,0,1,28,0,5,0,5,11,119,99,291,10,12,628,288,255,33,1393
2023,11020 Jerez de la Frontera,9204,2,6,109,0,65,15,50,250,455,257,3206,186,76,4849,2681,2386,295,11885
2023,11022 Línea de la Concepción (La),2204,1,1,55,1,22,8,14,29,46,26,348,48,53,1600,435,395,40,2639
2023,11027 Puerto de Santa María (El),3703,2,10,40,0,29,4,25,105,193,121,1090,76,62,2096,1036,946,90,4739
2023,11028 Puerto Real,1172,0,0,12,0,4,0,4,17,66,33,322,25,7,719,455,407,48,1627
2023,11030 Rota,1194,0,2,14,0,11,2,9,29,68,63,337,17,18,698,339,323,16,1533
2023,11031 San Fernando,3363,0,4,29,0,26,5,21,46,131,40,1237,86,17,1787,1279,1127,152,4642
2023,11033 San Roque,1419,0,3,31,0,18,3,15,12,65,33,214,20,29,1027,364,332,32,1783
2023,11032 Sanlúcar de Barrameda,2983,0,6,24,0,31,5,26,56,184,121,768,104,99,1711,781,685,96,3764
2023,Provincia de CÓRDOBA,24140,3,21,317,1,241,52,189,414,1464,1026,6743,269,152,14515,7670,6732,938,31810
2023,14013 Cabra,613,0,0,10,0,6,4,2,6,56,45,122,13,6,394,226,185,41,839
2023,14021 Córdoba,13027,1,14,103,1,141,33,108,285,557,321,4465,193,62,7205,3841,3392,449,16868
2023,14038 Lucena,1933,0,2,23,0,29,4,25,34,88,66,387,29,12,1329,524,451,73,2457
2023,14042 Montilla,382,0,0,14,0,4,2,2,3,31,25,84,2,10,234,181,159,22,563
2023,14049 Palma del Río,615,0,0,9,0,7,1,6,13,26,20,153,2,2,403,230,196,34,845
2023,14055 Priego de Córdoba,435,0,0,7,0,2,0,2,5,76,67,85,1,0,259,141,125,16,576
2023,14056 Puente Genil,863,0,0,16,0,4,0,4,18,67,49,224,9,6,519,199,179,20,1062
2023,Provincia de GRANADA,31815,11,28,425,1,301,47,254,632,2104,1653,8277,331,1178,18527,9937,8978,959,41752
2023,18017 Almuñécar,1080,0,0,14,0,11,1,10,23,80,73,323,25,12,592,286,267,19,1366
2023,18021 Armilla,1595,0,1,17,0,12,0,12,15,22,9,867,5,11,645,354,308,46,1949
2023,18022 Atarfe,680,0,2,11,0,3,0,3,19,41,29,100,5,38,461,210,185,25,890
2023,18023 Baza,793,0,0,15,0,4,1,3,12,75,47,229,20,4,434,190,181,9,983
2023,18905 Gabias (Las),680,3,0,10,0,6,2,4,14,37,33,241,2,16,351,285,247,38,965
2023,18087 Granada,10412,2,5,68,1,90,14,76,327,518,346,3649,128,232,5392,2851,2588,263,13263
2023,18122 Loja,444,0,2,9,0,1,0,1,4,28,17,83,2,26,289,164,145,19,608
2023,18127 Maracena,668,0,0,11,0,6,2,4,17,48,33,101,4,13,468,280,254,26,948
2023,18140 Motril,1982,1,2,20,0,27,2,25,39,105,82,469,34,64,1221,619,590,29,2601
2023,Provincia de HUELVA,20071,5,6,405,0,162,29,133,337,1309,968,4884,269,176,12518,3392,3004,388,23463
2023,21002 Aljaraque,392,0,1,7,0,1,0,1,2,39,29,45,6,8,283,183,164,19,575
2023,21005 Almonte,1726,0,0,33,0,13,0,13,19,110,96,481,12,12,1046,170,148,22,1896
2023,21010 Ayamonte,779,0,0,31,0,4,1,3,9,56,39,108,10,15,546,81,68,13,860
2023,21021 Cartaya,1331,1,0,37,0,8,2,6,19,101,80,297,10,3,855,145,135,10,1476
2023,21041 Huelva,6164,2,2,88,0,53,14,39,168,255,133,2166,123,37,3270,1501,1355,146,7665
2023,21042 Isla Cristina,875,0,0,23,0,12,2,10,17,59,40,140,13,8,603,39,36,3,914
2023,21044 Lepe,2061,1,1,37,0,9,0,9,32,132,112,545,16,7,1281,146,131,15,2207
2023,21050 Moguer,816,0,0,20,0,7,2,5,11,77,64,142,7,7,545,94,84,10,910
2023,Provincia de JAÉN,15547,2,17,215,1,141,37,104,207,1055,752,3692,155,161,9901,5526,5034,492,21073
2023,23002 Alcalá la Real,536,0,2,8,0,9,3,6,3,45,44,124,1,3,341,227,218,9,763
2023,23005 Andújar,1016,1,1,7,0,6,1,5,7,50,35,274,10,23,637,184,172,12,1200
2023,23050 Jaén,3520,0,5,36,0,41,14,27,77,166,107,1048,81,34,2032,1284,1166,118,4804
2023,23055 Linares,1239,0,3,10,0,5,3,2,25,65,38,362,10,32,727,412,372,40,1651
2023,23060 Martos,613,0,0,23,0,10,0,10,11,43,28,163,3,1,359,295,279,16,908
2023,23092 Úbeda,955,0,1,8,0,6,2,4,9,70,35,282,12,8,559,297,275,22,1252
2023,Provincia de MÁLAGA,81032,15,56,1034,16,758,153,605,1914,4632,3407,26834,1904,1249,42620,17993,16241,1752,99025
2023,29007 Alhaurín de la Torre,1062,0,0,11,1,10,0,10,12,74,64,186,25,18,725,373,350,23,1435
2023,29008 Alhaurín el Grande,761,0,0,16,0,3,0,3,14,85,73,112,7,18,506,195,187,8,956
2023,29015 Antequera,1142,1,1,17,0,7,1,6,23,76,55,289,23,9,696,428,391,37,1570
2023,29025 Benalmádena,3561,1,1,41,2,37,5,32,60,182,105,1028,92,63,2054,986,863,123,4547
2023,29038 Cártama,914,0,1,17,0,5,1,4,16,58,46,119,12,10,676,186,170,16,1100
2023,29042 Coín,757,0,2,9,0,10,2,8,16,65,56,132,12,8,503,157,142,15,914
2023,29051 Estepona,3619,1,2,43,3,43,9,34,47,286,208,859,104,60,2171,924,816,108,4543
2023,29054 Fuengirola,5876,1,4,55,1,49,11,38,186,221,114,2489,140,72,2658,733,659,74,6609
2023,29067 Málaga,28204,4,18,328,5,311,59,252,800,1047,661,11790,702,512,12687,6367,5709,658,34571
2023,29069 Marbella,11844,3,5,123,1,95,32,63,284,817,629,3623,355,146,6392,1794,1588,206,13638
2023,29070 Mijas,4594,0,4,55,1,31,4,27,100,383,347,1118,108,90,2704,1308,1235,73,5902
2023,29075 Nerja,1069,1,2,54,0,12,2,10,44,97,84,320,2,11,526,185,175,10,1254
2023,29082 Rincón de la Victoria,1427,0,1,19,2,16,2,14,24,91,73,358,28,9,879,513,474,39,1940
2023,29084 Ronda,997,0,1,12,0,4,0,4,15,63,35,337,16,6,543,307,257,50,1304
2023,29901 Torremolinos,4379,2,3,58,0,42,8,34,99,131,81,1643,77,93,2231,1014,898,116,5393
2023,29091 Torrox,791,0,1,18,0,6,3,3,9,76,60,199,5,8,469,130,126,4,921
2023,29094 Vélez-Málaga,3918,1,6,31,0,29,5,24,97,314,235,1282,109,39,2010,925,842,83,4843
2023,Provincia de SEVILLA,83899,15,84,1354,10,691,138,553,2639,5130,3092,25799,1686,618,45873,18961,17022,1939,102860
2023,41004 Alcalá de Guadaíra,3225,0,3,25,0,26,6,20,59,222,147,901,85,32,1872,811,717,94,4036
2023,41017 Bormujos,603,0,1,11,0,5,1,4,7,83,50,139,2,6,349,110,86,24,713
2023,41021 Camas,1121,0,1,10,0,13,1,12,15,52,26,275,39,4,712,353,331,22,1474
2023,41024 Carmona,1452,0,1,41,0,6,0,6,13,127,88,256,12,5,991,188,170,18,1640
2023,41034 Coria del Río,1320,0,1,11,0,8,1,7,28,112,80,285,31,15,829,305,268,37,1625
2023,41038 Dos Hermanas,5521,0,13,68,2,35,6,29,100,348,215,1394,51,71,3439,1501,1329,172,7022
2023,41039 Écija,1335,0,2,12,0,15,4,11,32,101,51,362,28,7,776,270,249,21,1605
2023,41053 Lebrija,737,0,1,39,0,11,0,11,5,24,17,186,4,12,455,307,269,38,1044
2023,41058 Mairena del Alcor,569,0,0,20,0,9,3,6,4,80,46,95,10,6,345,217,202,15,786
2023,41059 Mairena del Aljarafe,1697,0,0,30,0,7,1,6,28,198,140,446,27,4,957,548,502,46,2245
2023,41065 Morón de la Frontera,665,1,1,14,0,8,1,7,11,38,32,158,4,10,420,260,249,11,925
2023,41069 Palacios y Villafranca (Los),1098,0,4,40,0,3,0,3,36,78,50,286,6,14,631,406,373,33,1504
2023,41081 Rinconada (La),1112,1,0,58,0,9,4,5,21,70,28,206,36,6,705,176,142,34,1288
2023,41086 San Juan de Aznalfarache,1345,0,0,15,1,12,1,11,22,43,18,523,19,12,698,245,226,19,1590
2023,41091 Sevilla,44628,6,40,307,4,368,76,292,1995,2104,1059,17390,1176,269,20969,9132,8242,890,53760
2023,41093 Tomares,406,0,0,7,0,3,0,3,10,60,38,115,2,2,207,132,116,16,538
2023,41095 Utrera,1809,2,0,94,1,22,4,18,37,105,76,497,8,25,1018,568,501,67,2377
2023,ARAGÓN,38680,9,38,677,2,464,92,372,1076,2757,1955,10651,318,552,22136,12185,10891,1294,50865
2023,Provincia de HUESCA,5874,1,6,116,1,98,14,84,84,458,332,1464,39,100,3507,2113,1876,237,7987
2023,22125 Huesca,1380,0,0,47,0,22,5,17,34,60,40,440,16,44,717,419,381,38,1799
2023,Provincia de TERUEL,2690,1,0,71,0,38,10,28,13,229,171,509,12,26,1791,1289,1154,135,3979
2023,44216 Teruel,681,0,0,24,0,12,5,7,6,39,35,167,5,13,415,276,254,22,957
2023,Provincia de ZARAGOZA,30116,7,32,490,1,328,68,260,979,2070,1452,8678,267,426,16838,8783,7861,922,38899
2023,50297 Zaragoza,21037,3,24,319,0,226,54,172,917,1174,800,7102,187,363,10722,5635,5067,568,26672
2023,ASTURIAS (PRINCIPADO DE),25240,6,15,442,0,298,67,231,424,1574,990,7681,259,190,14351,8648,7897,751,33888
2023,Provincia de ASTURIAS,25240,6,15,442,0,298,67,231,424,1574,990,7681,259,190,14351,8648,7897,751,33888
2023,33004 Avilés,2024,0,2,23,0,16,2,14,45,189,74,644,27,20,1058,476,444,32,2500
2023,33016 Castrillón,370,0,0,7,0,3,0,3,1,23,17,102,3,2,229,223,198,25,593
2023,33024 Gijón,7179,2,5,124,0,102,35,67,165,393,243,2655,65,35,3633,2487,2337,150,9666
2023,33031 Langreo,1238,0,1,21,0,14,7,7,23,90,58,202,33,11,843,292,275,17,1530
2023,33037 Mieres,939,1,3,12,0,6,0,6,19,57,40,214,15,6,606,222,202,20,1161
2023,33044 Oviedo,5446,2,1,111,0,74,14,60,112,308,200,1851,45,49,2893,2045,1838,207,7491
2023,33066 Siero,1524,0,1,22,0,5,2,3,14,112,72,564,12,7,787,363,321,42,1887
2023,BALEARS (ILLES),67024,8,42,1300,4,990,156,834,1519,2688,1937,23009,1832,776,34856,11485,10299,1186,78509
2023,Provincia de BALEARES,67024,8,42,1300,4,990,156,834,1519,2688,1937,23009,1832,776,34856,11485,10299,1186,78509
2023,07026 Eivissa,3882,0,6,64,0,39,9,30,95,118,57,1422,72,120,1946,662,634,28,4544
2023,07046 Sant Antoni de Portmany,2150,1,3,71,0,42,9,33,67,74,56,470,130,76,1216,206,185,21,2356
2023,07048 Sant Josep de sa Talaia,2702,0,3,63,0,41,7,34,81,131,108,845,146,83,1309,252,238,14,2954
2023,07054 Santa Eulària des Riu,1881,0,0,37,0,29,2,27,29,122,97,391,89,26,1158,261,236,25,2142
2023,07003 Alcudia,1462,0,0,41,0,28,7,21,29,92,51,651,3,2,616,62,54,8,1524
2023,07011 Calvià,4303,0,3,101,0,78,19,59,119,188,165,1456,33,102,2223,588,522,66,4891
2023,07027 Inca,1207,0,0,41,0,33,2,31,22,74,57,219,24,3,791,207,174,33,1414
2023,07031 Llucmajor,1901,1,0,53,0,43,3,40,39,100,80,543,20,11,1091,453,398,55,2354
2023,07033 Manacor,1758,1,4,33,0,35,6,29,26,143,89,453,34,14,1015,431,393,38,2189
2023,07036 Marratxí,1242,0,0,21,0,17,2,15,4,40,31,366,23,17,754,337,302,35,1579
2023,07040 Palma,29397,3,12,348,3,366,49,317,875,604,344,12532,1025,212,13417,5525,5015,510,34922
2023,07015 Ciutadella de Menorca,1487,0,3,29,0,15,4,11,16,91,56,425,43,8,857,361,322,39,1848
2023,07032 Maó-Mahón,1253,0,3,25,0,21,5,16,10,23,10,241,17,27,886,251,238,13,1504
2023,CANARIAS,86551,17,60,1383,6,1097,220,877,1858,3396,2120,26245,1451,764,50274,17671,15752,1919,104222
2023,Provincia de PALMAS (LAS),46283,6,32,745,3,618,123,495,996,1606,998,13243,744,404,27886,10343,9152,1191,56626
2023,35014 Oliva (La),1639,0,1,32,0,12,1,11,36,75,64,656,7,6,814,258,235,23,1897
2023,35015 Pájara,1087,0,1,43,0,13,1,12,30,28,14,344,6,8,614,149,132,17,1236
2023,35017 Puerto del Rosario,2036,0,1,45,0,23,0,23,38,94,35,480,52,19,1284,603,500,103,2639
2023,35002 Agüimes,1045,0,0,7,0,12,2,10,10,59,23,200,6,5,746,232,219,13,1277
2023,35006 Arucas,825,0,0,16,0,15,2,13,5,23,13,160,3,0,603,390,355,35,1215
2023,35009 Gáldar,665,0,1,13,0,8,2,6,8,11,9,105,0,4,515,214,206,8,879
2023,35011 Ingenio,760,0,2,5,0,14,2,12,7,17,11,134,4,1,576,237,221,16,997
2023,35012 Mogán,1727,0,0,21,0,13,1,12,24,65,47,688,20,5,891,107,103,4,1834
2023,35016 Palmas de Gran Canaria (Las),16012,2,11,195,2,203,54,149,477,531,350,5031,315,179,9066,4160,3649,511,20172
2023,35019 San Bartolomé de Tirajana,4219,0,2,62,0,54,11,43,108,102,42,1863,85,60,1883,313,278,35,4532
2023,35022 Santa Lucía de Tirajana,2517,0,2,53,0,36,1,35,47,53,43,622,15,19,1670,369,310,59,2886
2023,35026 Telde,4307,0,1,41,0,53,15,38,48,153,104,820,168,26,2997,1126,937,189,5433
2023,35004 Arrecife,2273,0,5,54,1,49,17,32,61,87,34,477,27,31,1481,199,185,14,2472
2023,35024 Teguise,549,1,0,16,0,12,3,9,5,29,14,93,1,10,382,171,161,10,720
2023,35028 Tías,1262,1,2,27,0,17,1,16,38,40,21,472,4,5,656,233,218,15,1495
2023,Provincia de SANTA CRUZ DE TENERIFE,40268,11,28,638,3,479,97,382,862,1790,1122,13002,707,360,22388,7328,6600,728,47596
2023,38024 Llanos de Aridane (Los),632,0,0,16,0,5,1,4,8,44,7,115,2,4,438,25,20,5,657
2023,38001 Adeje,4571,3,5,69,1,43,13,30,125,206,137,2130,108,66,1815,383,334,49,4954
2023,38006 Arona,6097,2,7,103,0,57,17,40,251,230,137,2540,132,90,2685,561,492,69,6658
2023,38011 Candelaria,542,0,1,17,0,8,4,4,3,32,18,96,8,3,374,283,263,20,825
2023,38017 Granadilla de Abona,2375,0,0,35,0,30,0,30,31,102,63,675,59,15,1428,483,449,34,2858
2023,38019 Guía de Isora,978,0,0,17,0,13,3,10,6,43,24,272,8,2,617,202,175,27,1180
2023,38020 Güímar,597,0,0,16,0,8,1,7,5,29,19,75,6,2,456,133,123,10,730
2023,38022 Icod de los Vinos,408,0,0,9,0,7,0,7,4,48,41,72,1,2,265,39,30,9,447
2023,38026 Orotava (La),1233,0,1,17,0,23,2,21,10,54,37,505,4,2,617,127,106,21,1360
2023,38028 Puerto de la Cruz,2000,0,0,22,0,24,6,18,52,83,45,907,28,12,872,259,230,29,2259
2023,38031 Realejos (Los),673,0,1,3,1,10,3,7,4,70,60,135,4,4,441,248,233,15,921
2023,38023 San Cristóbal de La Laguna,5056,2,7,63,0,56,11,45,124,173,109,1371,121,49,3090,1489,1362,127,6545
2023,38035 San Miguel de Abona,1299,0,0,21,0,11,3,8,22,105,68,386,39,4,711,334,307,27,1633
2023,38038 Santa Cruz de Tenerife,7591,0,2,104,1,100,16,84,172,172,98,2453,125,66,4396,1710,1547,163,9301
2023,38043 Tacoronte,607,0,0,7,0,6,0,6,14,32,17,122,9,2,415,71,62,9,678
2023,CANTABRIA,18244,0,10,374,0,157,34,123,255,1783,1291,4831,116,114,10604,5968,5428,540,24212
2023,Provincia de CANTABRIA,18244,0,10,374,0,157,34,123,255,1783,1291,4831,116,114,10604,5968,5428,540,24212
2023,39016 Camargo,1114,0,1,19,0,4,1,3,7,89,65,456,4,1,533,330,309,21,1444
2023,39020 Castro-Urdiales,1262,0,0,25,0,13,3,10,17,105,92,315,4,8,775,405,376,29,1667
2023,39052 Piélagos,506,0,0,14,0,4,1,3,2,77,64,76,5,0,328,300,276,24,806
2023,39075 Santander,6012,0,3,123,0,56,16,40,108,404,298,2222,59,56,2981,1956,1762,194,7968
2023,39087 Torrelavega,1711,0,2,42,0,12,4,8,44,142,79,409,17,15,1028,465,409,56,2176
2023,CASTILLA Y LEON,64278,10,48,1023,0,624,141,483,817,4169,2786,17611,485,492,38999,25546,22722,2824,89824
2023,Provincia de ÁVILA,4396,1,4,96,0,40,14,26,26,353,269,784,28,39,3025,1839,1684,155,6235
2023,05019 Ávila,1140,1,0,17,0,15,8,7,5,58,31,313,13,5,713,700,661,39,1840
2023,Provincia de BURGOS,10410,1,3,160,0,97,22,75,183,877,588,2828,92,82,6087,3560,3205,355,13970
2023,09018 Aranda de Duero,1214,0,0,14,0,17,2,15,21,53,38,314,6,2,787,375,344,31,1589
2023,09059 Burgos,4544,0,2,56,0,48,17,31,129,263,146,1709,55,46,2236,1758,1592,166,6302
2023,09219 Miranda de Ebro,1135,1,1,24,0,7,2,5,9,105,78,239,17,9,723,288,268,20,1423
2023,Provincia de LEÓN,12473,3,11,175,0,118,25,93,187,856,485,3496,86,60,7481,4354,3858,496,16827
2023,24089 León,4991,1,3,65,0,45,9,36,117,304,87,2012,44,17,2383,1465,1324,141,6456
2023,24115 Ponferrada,1802,0,5,19,0,20,5,15,27,140,117,489,10,10,1082,673,588,85,2475
2023,24142 San Andrés del Rabanedo,695,0,0,2,0,11,3,8,13,40,22,172,6,3,448,388,346,42,1083
2023,Provincia de PALENCIA,3477,0,4,60,0,27,3,24,43,146,109,780,23,55,2339,1438,1324,114,4915
2023,34120 Palencia,1652,0,3,31,0,14,3,11,38,56,48,488,17,21,984,578,553,25,2230
2023,Provincia de SALAMANCA,8894,2,3,135,0,105,27,78,124,434,295,3038,64,67,4922,3801,3221,580,12695
2023,37274 Salamanca,5253,0,2,61,0,56,17,39,104,227,159,2112,42,37,2612,1837,1495,342,7090
2023,Provincia de SEGOVIA,4095,0,1,63,0,45,10,35,31,299,224,909,37,45,2665,1855,1655,200,5950
2023,40194 Segovia,1359,0,1,13,0,19,5,14,23,37,28,460,8,23,775,478,456,22,1837
2023,Provincia de SORIA,2488,0,4,34,0,30,8,22,21,194,132,516,16,29,1644,1227,1120,107,3715
2023,42173 Soria,1177,0,2,15,0,19,7,12,12,61,44,303,8,21,736,682,623,59,1859
2023,Provincia de VALLADOLID,13981,2,16,227,0,124,29,95,182,734,488,4306,111,59,8220,6059,5393,666,20040
2023,47010 Arroyo de la Encomienda,1054,0,0,12,0,7,0,7,5,39,27,579,6,1,405,400,351,49,1454
2023,47076 Laguna de Duero,596,0,1,9,0,8,1,7,4,15,8,155,1,2,401,398,323,75,994
2023,47085 Medina del Campo,466,0,1,14,0,5,1,4,6,22,18,105,3,0,310,184,170,14,650
2023,47186 Valladolid,7768,2,13,111,0,85,22,63,148,338,214,2739,74,44,4214,2957,2676,281,10725
2023,Provincia de ZAMORA,4064,1,2,73,0,38,3,35,20,276,196,954,28,56,2616,1413,1262,151,5477
2023,49275 Zamora,1512,0,0,14,0,14,3,11,8,83,67,440,18,23,912,540,500,40,2052
2023,CASTILLA - LA MANCHA,64252,15,45,980,3,649,133,516,926,5034,3588,14785,645,595,40575,19456,17335,2121,83708
2023,Provincia de ALBACETE,12002,5,7,172,0,124,31,93,211,851,636,3771,122,96,6643,3616,3229,387,15618
2023,02003 Albacete,6541,3,0,77,0,72,22,50,135,303,218,2614,67,33,3237,1837,1670,167,8378
2023,02009 Almansa,511,0,0,8,0,6,0,6,3,57,40,122,10,1,304,187,161,26,698
2023,02037 Hellín,1180,1,0,32,0,10,3,7,36,166,124,209,6,8,712,241,222,19,1421
2023,02081 Villarrobledo,851,0,4,15,0,6,1,5,16,52,33,300,2,23,433,283,250,33,1134
2023,Provincia de CIUDAD REAL,12156,3,11,202,1,134,27,107,191,826,585,2931,88,122,7647,3542,3190,352,15698
2023,13005 Alcázar de San Juan,793,0,1,15,0,9,1,8,16,38,26,212,14,6,482,326,299,27,1119
2023,13034 Ciudad Real,2394,0,2,19,0,35,12,23,55,137,85,967,26,17,1136,785,722,63,3179
2023,13071 Puertollano,1455,0,2,22,1,11,2,9,55,74,51,319,18,20,933,384,349,35,1839
2023,13082 Tomelloso,925,0,1,27,0,12,0,12,19,45,36,196,1,15,609,166,156,10,1091
2023,13087 Valdepeñas,592,1,0,9,0,6,1,5,6,30,23,134,3,8,395,105,92,13,697
2023,Provincia de CUENCA,5687,3,3,110,1,44,7,37,49,460,325,1159,24,49,3785,1707,1536,171,7394
2023,16078 Cuenca,2091,0,2,38,0,13,4,9,24,126,69,557,9,9,1313,652,592,60,2743
2023,Provincia de GUADALAJARA,9274,1,6,119,0,91,18,73,131,674,462,1905,128,62,6157,3399,3096,303,12673
2023,19046 Azuqueca de Henares,1614,0,2,7,0,26,5,21,33,71,39,317,25,7,1126,497,445,52,2111
2023,19130 Guadalajara,2988,0,1,41,0,28,9,19,63,157,84,873,40,27,1758,986,936,50,3974
2023,Provincia de TOLEDO,25133,3,18,377,1,256,50,206,344,2223,1580,5019,283,266,16343,7192,6284,908,32325
2023,45081 Illescas,1500,0,0,17,0,15,2,13,30,105,56,380,31,9,913,301,238,63,1801
2023,45161 Seseña,1277,0,2,20,0,14,2,12,12,49,37,231,12,9,928,394,339,55,1671
2023,45165 Talavera de la Reina,2639,0,2,39,0,31,8,23,52,134,78,847,36,42,1456,421,387,34,3060
2023,45168 Toledo,2851,1,4,28,0,24,7,17,42,166,118,986,38,13,1549,673,627,46,3524
2023,CATALUÑA,433959,71,239,4036,11,4217,1588,2629,25421,27372,18485,170164,8466,4368,189594,76213,73994,2219,510172
2023,Provincia de BARCELONA,337739,46,169,2813,9,3102,1178,1924,22792,18504,12042,141789,6986,3216,138313,54959,53494,1465,392698
2023,08015 Badalona,11870,3,10,133,1,109,37,72,1373,542,344,3970,234,75,5420,2298,2232,66,14168
2023,08252 Barberà del Vallès,1480,0,2,12,1,16,7,9,37,119,65,457,49,5,782,220,214,6,1700
2023,08019 Barcelona,166605,12,43,947,3,1225,442,783,13677,7554,4909,85652,3170,1711,52611,19561,19082,479,186166
2023,08051 Castellar del Vallès,324,0,0,0,0,9,5,4,13,21,15,55,14,3,209,173,165,8,497
2023,08056 Castelldefels,2813,0,0,30,0,41,17,24,74,218,188,1043,69,21,1317,607,584,23,3420
2023,08266 Cerdanyola del Vallès,1606,0,1,23,0,21,9,12,56,143,98,421,37,21,883,499,481,18,2105
2023,08073 Cornellà de Llobregat,4536,2,3,59,0,64,21,43,407,190,94,1604,164,34,2009,994,973,21,5530
2023,08076 Esparreguera,388,0,0,13,0,8,5,3,8,22,13,83,11,4,239,117,110,7,505
2023,08077 Esplugues de Llobregat,2654,0,0,19,0,13,4,9,159,133,87,1242,83,7,998,503,488,15,3157
2023,08086 Les Franqueses del Vallès,612,0,1,8,0,9,3,6,32,52,21,107,16,3,384,108,103,5,720
2023,08089 Gavà,1883,0,0,13,0,17,6,11,39,102,64,687,54,7,964,558,548,10,2441
2023,08096 Granollers,2777,0,5,36,0,36,15,21,201,153,87,809,49,6,1482,438,427,11,3215
2023,08101 Hospitalet de Llobregat (L'),18922,3,16,175,1,190,86,104,1911,689,386,6939,334,99,8565,1258,1225,33,20180
2023,08102 Igualada,1534,0,1,22,0,34,16,18,48,135,97,478,41,10,765,489,468,21,2023
2023,08112 Manlleu,277,0,0,6,0,4,2,2,10,24,14,55,3,8,167,153,151,2,430
2023,08113 Manresa,3642,1,2,72,0,56,27,29,171,275,160,1108,47,14,1896,985,960,25,4627
2023,08114 Martorell,1232,0,0,14,0,11,7,4,56,71,47,423,23,14,620,290,287,3,1522
2023,08118 Masnou (El),555,0,0,13,0,10,4,6,23,39,30,173,24,4,269,239,233,6,794
2023,08121 Mataró,7497,0,5,105,1,67,21,46,642,325,194,2287,204,56,3805,1397,1362,35,8894
2023,08123 Molins de Rei,822,0,0,12,0,10,2,8,37,102,61,229,37,3,392,231,222,9,1053
2023,08124 Mollet del Vallès,2266,0,1,19,0,23,10,13,65,111,72,568,42,12,1425,178,173,5,2444
2023,08125 Montcada i Reixac,2363,0,1,28,0,12,5,7,86,147,79,520,40,5,1524,333,329,4,2696
2023,08147 Olesa de Montserrat,340,0,1,9,0,9,3,6,6,33,20,78,11,0,193,123,118,5,463
2023,08163 Pineda de Mar,1131,0,3,10,0,19,8,11,32,67,52,361,18,7,614,369,359,10,1500
2023,08169 Prat de Llobregat (El),9347,0,2,34,0,30,6,24,166,122,49,6079,263,292,2359,739,711,28,10086
2023,08172 Premià de Mar,1017,0,1,10,0,10,6,4,60,67,42,260,30,4,575,306,299,7,1323
2023,08180 Ripollet,1234,1,2,14,1,12,7,5,40,86,60,295,42,14,727,284,280,4,1518
2023,08184 Rubí,3297,0,5,33,0,44,15,29,145,279,110,770,79,18,1924,566,559,7,3863
2023,08187 Sabadell,8097,1,8,70,0,108,39,69,373,486,346,2602,200,54,4195,1976,1912,64,10073
2023,08194 Sant Adrià de Besòs,3324,2,3,15,0,26,11,15,234,145,64,1069,75,43,1712,415,405,10,3739
2023,08196 Sant Andreu de la Barca,425,1,0,10,0,8,2,6,12,39,26,67,11,7,270,176,171,5,601
2023,08200 Sant Boi de Llobregat,3320,1,1,42,0,34,10,24,133,153,80,1134,109,14,1699,937,918,19,4257
2023,08205 Sant Cugat del Vallès,3799,1,0,28,0,36,10,26,108,373,305,1357,65,8,1823,874,841,33,4673
2023,08211 Sant Feliu de Llobregat,1337,0,0,10,0,19,10,9,63,123,90,372,57,6,687,446,432,14,1783
2023,08217 Sant Joan Despí,942,0,0,6,0,10,2,8,43,99,66,302,48,5,429,390,379,11,1332
2023,08221 Sant Just Desvern,485,0,0,5,0,2,1,1,24,73,55,134,22,1,224,200,196,4,685
2023,08231 Sant Pere de Ribes,739,0,0,7,0,13,5,8,15,56,53,161,31,5,451,296,284,12,1035
2023,08238 Sant Quirze del Vallès,496,0,1,6,0,5,1,4,15,40,21,156,6,3,264,113,107,6,609
2023,08263 Sant Vicenç dels Horts,1059,0,0,9,0,15,4,11,33,76,48,286,24,6,610,285,280,5,1344
2023,08245 Santa Coloma de Gramenet,4693,1,3,55,0,48,21,27,395,176,118,1508,88,22,2397,623,612,11,5316
2023,08260 Santa Perpètua de Mogoda,1060,0,1,8,0,10,4,6,31,82,35,270,24,82,552,282,276,6,1342
2023,08270 Sitges,3008,0,1,22,0,16,10,6,165,153,123,1342,47,19,1243,354,341,13,3362
2023,08279 Terrassa,8621,2,7,98,1,85,43,42,345,608,343,2464,206,35,4770,1532,1488,44,10153
2023,08298 Vic,1912,1,3,27,0,36,14,22,73,119,69,676,13,17,947,463,453,10,2375
2023,08301 Viladecans,2761,0,2,33,0,16,5,11,71,111,68,1109,73,9,1337,616,598,18,3377
2023,08305 Vilafranca del Penedès,2213,1,3,33,0,20,3,17,123,172,90,763,35,11,1052,443,430,13,2656
2023,08307 Vilanova i la Geltrú,3664,0,4,39,0,39,14,25,138,214,140,1234,74,20,1902,860,844,16,4524
2023,08219 Vilassar de Mar,499,0,0,7,0,9,2,7,34,53,44,130,15,1,250,179,171,8,678
2023,Provincia de GIRONA,39543,8,19,542,1,414,156,258,1054,3543,2561,12993,686,553,19730,8680,8397,283,48223
2023,17015 Banyoles,802,0,0,11,0,2,1,1,13,56,22,286,2,11,421,253,246,7,1055
2023,17023 Blanes,2068,0,0,24,0,15,4,11,93,118,81,732,32,16,1038,327,318,9,2395
2023,17066 Figueres,3235,1,2,45,0,32,8,24,92,206,89,1011,61,46,1739,525,509,16,3760
2023,17079 Girona,5892,2,0,80,0,71,24,47,323,357,234,2345,157,17,2540,1337,1278,59,7229
2023,17095 Lloret de Mar,2638,0,2,28,1,36,19,17,74,141,127,1276,32,84,964,360,347,13,2998
2023,17114 Olot,1094,0,0,19,0,7,3,4,42,111,82,287,13,6,609,487,476,11,1581
2023,17117 Palafrugell,1072,0,0,20,0,11,5,6,18,95,73,274,32,7,615,237,226,11,1309
2023,17152 Roses,1476,0,0,5,0,13,5,8,29,136,99,540,30,14,709,265,255,10,1741
2023,17155 Salt,1801,0,1,19,0,19,8,11,79,56,34,738,25,9,855,382,379,3,2183
2023,17160 Sant Feliu de Guíxols,907,0,0,11,0,10,3,7,12,92,65,247,27,17,491,281,270,11,1188
2023,Provincia de LLEIDA,17609,3,13,262,1,268,105,163,395,1443,1068,4676,236,135,10177,4745,4517,228,22354
2023,25120 Lleida,7558,0,2,77,0,130,51,79,288,472,343,2707,130,29,3723,1724,1618,106,9282
2023,Provincia de TARRAGONA,39068,14,38,419,0,433,149,284,1180,3882,2814,10706,558,464,21374,7829,7586,243,46897
2023,43014 Amposta,1074,0,0,10,0,14,3,11,24,91,60,323,9,9,594,269,265,4,1343
2023,43037 Calafell,1058,0,4,19,0,21,9,12,43,83,72,267,20,19,582,193,190,3,1251
2023,43038 Cambrils,1237,0,0,11,0,19,5,14,24,106,83,365,25,19,668,414,401,13,1651
2023,43123 Reus,4604,3,4,39,0,59,20,39,231,506,311,1101,85,44,2532,1159,1127,32,5763
2023,43905 Salou,2983,3,2,39,0,30,10,20,82,228,165,928,37,36,1598,213,203,10,3196
2023,43148 Tarragona,8284,2,5,61,0,73,24,49,312,565,334,3084,127,50,4005,1107,1070,37,9391
2023,43155 Tortosa,1492,0,4,16,0,34,8,26,40,176,119,377,21,16,808,527,495,32,2019
2023,43161 Valls,1180,1,0,13,0,13,7,6,31,118,100,230,19,6,749,280,272,8,1460
2023,43163 Vendrell (El),2705,0,3,28,0,34,12,22,192,196,155,776,29,32,1415,488,479,9,3193
2023,43171 Vila-seca,1483,0,1,13,0,8,3,5,15,92,63,489,22,12,831,159,156,3,1642
2023,COMUNITAT VALENCIANA,240319,34,166,3302,16,2385,472,1913,6170,18510,14495,77573,3258,2566,126339,47060,41313,5747,287379
2023,Provincia de ALICANTE/ALACANT,87463,11,66,1177,8,959,221,738,1997,7578,6275,27014,1430,1105,46118,17910,15789,2121,105373
2023,03009 Alcoy/Alcoi,1565,0,1,6,0,13,2,11,34,134,105,394,42,7,934,611,535,76,2176
2023,03011 L'Alfàs del Pi,1031,0,0,8,1,8,2,6,20,127,103,334,14,6,513,171,153,18,1202
2023,03014 Alicante/Alacant,20517,4,23,200,2,223,51,172,709,940,683,7426,363,357,10270,4142,3492,650,24659
2023,03015 Almoradí,860,0,0,16,0,7,1,6,19,73,55,233,8,9,495,195,166,29,1055
2023,03018 Altea,1412,0,0,18,0,13,2,11,24,207,170,411,28,9,702,223,200,23,1635
2023,03019 Aspe,631,1,1,7,0,4,0,4,9,65,49,100,3,5,436,156,115,41,787
2023,03031 Benidorm,5351,0,4,140,0,64,23,41,137,153,98,2284,59,161,2349,857,793,64,6208
2023,03047 Calp,1534,0,0,19,1,12,2,10,18,162,147,514,27,7,774,317,293,24,1851
2023,03050 Campello (el),1196,0,0,10,0,9,4,5,14,80,66,393,10,11,669,439,357,82,1635
2023,03059 Crevillent,793,0,2,27,0,23,5,18,12,52,44,159,9,11,498,121,97,24,914
2023,03063 Dénia,2165,0,1,30,0,28,7,21,23,303,271,620,70,25,1065,467,438,29,2632
2023,03065 Elche/Elx,7908,2,2,84,0,100,20,80,168,492,388,2623,202,135,4100,1771,1615,156,9679
2023,03066 Elda,1854,0,4,26,0,17,9,8,45,134,92,529,35,31,1033,471,410,61,2325
2023,03079 Ibi,656,0,1,7,1,8,1,7,7,79,68,154,4,2,393,230,209,21,886
2023,03082 Jávea/Xàbia,1672,0,0,26,0,11,0,11,35,355,334,466,42,8,729,241,219,22,1913
2023,03090 Mutxamel,521,0,1,5,0,6,2,4,6,55,50,112,6,7,323,230,199,31,751
2023,03093 Novelda,672,0,0,12,0,16,4,12,18,44,30,139,4,5,434,89,71,18,761
2023,03099 Orihuela,3933,2,5,57,1,29,8,21,77,584,518,1188,74,36,1880,560,526,34,4493
2023,03104 Petrer,847,0,4,10,0,9,2,7,22,63,47,219,15,10,495,242,198,44,1089
2023,03902 Pilar de la Horadada,1509,0,2,12,0,10,3,7,16,245,216,494,32,9,689,204,190,14,1713
2023,03122 San Vicente del Raspeig/Sant Vicent del Raspeig,1843,0,2,30,0,25,3,22,32,115,78,531,19,8,1081,621,547,74,2464
2023,03119 Sant Joan d'Alacant,809,0,0,8,0,5,0,5,14,54,43,237,15,4,472,279,243,36,1088
2023,03121 Santa Pola,1841,0,0,21,0,30,6,24,41,94,65,640,17,8,990,497,449,48,2338
2023,03133 Torrevieja,8041,1,2,146,2,73,20,53,206,499,416,2469,107,87,4449,782,714,68,8823
2023,03139 Villajoyosa/Vila Joiosa (la),1813,0,0,28,0,13,5,8,37,83,59,558,24,10,1060,352,317,35,2165
2023,03140 Villena,859,1,0,7,0,10,3,7,17,98,88,201,6,25,494,309,284,25,1168
2023,Provincia de CASTELLÓN/CASTELLÓ,25192,5,18,455,2,262,37,225,456,2325,1741,6986,217,171,14295,3958,3557,401,29150
2023,12009 Almazora/Almassora,1440,1,2,19,1,4,0,4,18,112,78,303,17,13,950,158,147,11,1598
2023,12027 Benicarló,1819,0,1,13,0,15,3,12,45,99,68,636,10,9,991,258,216,42,2077
2023,12032 Borriana/Burriana,1936,0,1,62,0,18,3,15,42,130,110,636,7,7,1033,295,267,28,2231
2023,12040 Castellón de la Plana/Castelló de la Plana,6121,2,7,93,1,80,7,73,158,512,375,2168,105,49,2946,1042,951,91,7163
2023,12084 Onda,946,0,0,41,0,17,4,13,15,61,50,167,7,7,631,192,166,26,1138
2023,12126 Vall d'Uixó (la),1126,1,0,28,0,10,2,8,15,122,80,183,3,5,759,175,152,23,1301
2023,12135 Vila-real,1286,0,2,21,0,17,3,14,20,136,99,348,20,6,716,270,255,15,1556
2023,12138 Vinaròs,1651,0,1,29,0,16,1,15,26,147,119,458,3,10,961,233,209,24,1884
2023,Provincia de VALENCIA/VALÈNCIA,127664,18,82,1670,6,1164,214,950,3717,8607,6479,43573,1611,1290,65926,25192,21967,3225,152856
2023,46005 Alaquàs,718,0,0,9,1,9,4,5,35,42,18,178,8,10,426,176,163,13,894
2023,46013 Alboraia/Alboraya,1472,0,0,18,0,9,2,7,31,89,56,537,25,8,755,246,220,26,1718
2023,46021 Aldaia,1900,0,1,18,0,10,2,8,28,41,18,1090,14,9,689,218,205,13,2118
2023,46022 Alfafar,1492,0,0,10,0,12,1,11,39,55,41,526,7,3,840,272,229,43,1764
2023,46029 Algemesí,1005,0,0,11,0,9,3,6,19,70,56,250,10,11,625,191,168,23,1196
2023,46017 Alzira,2309,1,1,30,0,28,6,22,42,319,266,622,19,24,1223,415,373,42,2724
2023,46070 Bétera,778,0,0,16,0,11,0,11,20,100,88,145,14,3,469,233,199,34,1011
2023,46078 Burjassot,1183,0,0,3,0,17,1,16,27,75,61,352,11,12,686,299,274,25,1482
2023,46083 Carcaixent,914,0,0,19,0,12,2,10,17,65,56,298,9,3,491,209,180,29,1123
2023,46094 Catarroja,860,0,0,9,0,13,2,11,29,77,41,159,13,3,557,248,213,35,1108
2023,46105 Cullera,2578,0,1,34,0,22,4,18,75,135,108,1295,26,21,969,296,271,25,2874
2023,46131 Gandia,3995,1,4,56,0,41,6,35,96,261,169,1209,79,61,2187,832,770,62,4827
2023,46147 Llíria,1055,0,0,20,0,11,3,8,15,144,123,226,7,10,622,223,174,49,1278
2023,46159 Manises,1146,0,2,13,0,7,2,5,20,47,34,369,57,48,583,206,189,17,1352
2023,46169 Mislata,1231,0,0,14,0,22,4,18,35,99,81,318,12,7,724,453,428,25,1684
2023,46171 Moncada,813,0,0,15,0,5,1,4,15,78,62,189,10,3,498,139,121,18,952
2023,46181 Oliva,1024,0,0,28,0,5,1,4,12,126,113,213,31,6,603,217,198,19,1241
2023,46184 Ontinyent,777,0,0,14,0,7,1,6,9,49,44,180,6,7,505,353,332,21,1130
2023,46186 Paiporta,628,0,0,17,0,8,2,6,15,45,31,125,20,7,391,182,155,27,810
2023,46190 Paterna,2650,0,4,20,0,24,6,18,82,240,194,662,60,26,1532,776,708,68,3426
2023,46194 Picassent,960,2,0,16,0,16,1,15,15,66,50,203,6,81,555,124,99,25,1084
2023,46202 Pobla de Vallbona (la),797,0,1,15,0,13,3,10,9,76,64,164,12,6,501,228,171,57,1025
2023,46205 Puçol,721,0,0,9,0,9,0,9,10,31,18,142,2,4,514,57,39,18,778
2023,46102 Quart de Poblet,1012,0,3,7,0,3,1,2,26,58,32,287,37,6,585,254,235,19,1266
2023,46213 Requena,919,0,0,32,0,7,2,5,12,51,38,172,1,14,630,202,173,29,1121
2023,46214 Riba-roja de Túria,1222,0,2,19,0,12,0,12,10,107,89,299,20,9,744,219,201,18,1441
2023,46220 Sagunto/Sagunt,3041,0,4,45,0,28,2,26,57,208,166,863,56,25,1755,368,330,38,3409
2023,46235 Sueca,1556,0,0,46,0,13,2,11,24,84,78,376,9,19,985,254,219,35,1810
2023,46244 Torrent,3096,0,4,32,1,20,4,16,72,197,149,915,48,41,1766,783,670,113,3879
2023,46250 Valencia,56528,6,39,551,3,471,99,372,2357,2497,1707,25411,633,602,23958,8768,7902,866,65296
2023,46145 Xàtiva,1058,0,0,21,0,9,1,8,13,80,58,314,11,8,602,262,236,26,1320
2023,46110 Xirivella,1026,0,1,16,0,12,2,10,23,41,31,299,13,3,618,242,230,12,1268
2023,EXTREMADURA,26450,4,17,434,0,261,44,217,312,1864,1266,6793,195,315,16255,8819,7449,1370,35269
2023,Provincia de BADAJOZ,17971,2,13,288,0,169,26,143,231,1361,967,4844,159,228,10676,5683,4809,874,23654
2023,06011 Almendralejo,1271,0,0,13,0,6,0,6,10,94,51,274,27,32,815,315,267,48,1586
2023,06015 Badajoz,6358,1,3,75,0,68,9,59,143,404,277,2049,71,69,3475,1874,1589,285,8232
2023,06044 Don Benito,1031,0,2,14,0,4,1,3,19,83,63,269,13,7,620,327,289,38,1358
2023,06083 Mérida,2235,0,2,21,0,17,2,15,27,116,81,625,19,28,1380,722,602,120,2957
2023,06153 Villanueva de la Serena,671,0,0,6,0,3,0,3,5,52,32,162,5,7,431,214,188,26,885
2023,Provincia de CÁCERES,8479,2,4,146,0,92,18,74,81,503,299,1949,36,87,5579,3136,2640,496,11615
2023,10037 Cáceres,2425,0,0,26,0,22,4,18,41,174,98,751,18,31,1362,1156,922,234,3581
2023,10148 Plasencia,1257,1,0,15,0,11,1,10,24,48,22,402,11,8,737,421,373,48,1678
2023,GALICIA,73067,18,52,1130,4,821,201,620,1049,4702,2684,20300,580,488,43923,21733,18721,3012,94800
2023,Provincia de CORUÑA (A),33207,12,16,422,2,335,78,257,552,2119,1197,9811,187,157,19594,8904,7639,1265,42111
2023,15002 Ames,675,0,1,8,0,8,4,4,11,29,19,127,4,2,485,360,324,36,1035
2023,15005 Arteixo,989,1,0,15,0,9,3,6,6,71,34,229,15,6,637,387,326,61,1376
2023,15017 Cambre,511,0,0,6,1,2,0,2,2,52,37,77,1,4,366,235,204,31,746
2023,15019 Carballo,1065,0,0,19,0,5,2,3,15,117,99,198,13,3,695,245,208,37,1310
2023,15030 Coruña (A),10182,3,3,78,0,69,15,54,284,484,194,4439,36,50,4736,2097,1844,253,12279
2023,15031 Culleredo,976,1,0,12,0,8,1,7,13,58,29,274,10,0,600,373,309,64,1349
2023,15036 Ferrol,2483,1,1,25,0,21,12,9,62,103,75,645,16,18,1591,540,451,89,3023
2023,15054 Narón,948,0,0,14,0,6,3,3,15,48,27,253,7,3,602,296,243,53,1244
2023,15058 Oleiros,908,0,0,11,0,12,3,9,11,64,44,225,5,3,577,421,370,51,1329
2023,15073 Ribeira,1109,0,2,33,0,12,1,11,18,71,36,247,6,3,717,208,194,14,1317
2023,15078 Santiago de Compostela,3981,2,4,47,0,61,13,48,50,263,110,1379,17,30,2128,788,643,145,4769
2023,Provincia de LUGO,7105,1,11,139,1,86,24,62,67,453,279,1894,33,62,4358,2050,1798,252,9155
2023,27028 Lugo,3264,0,3,56,0,33,9,24,52,174,93,1225,9,31,1681,883,813,70,4147
2023,Provincia de OURENSE,7372,0,3,151,1,104,23,81,101,591,363,1740,46,34,4601,2252,1905,347,9624
2023,32054 Ourense,3532,0,2,71,0,43,15,28,82,269,144,1016,14,17,2018,1036,906,130,4568
2023,Provincia de PONTEVEDRA,25383,5,22,418,0,296,76,220,329,1539,845,6855,314,235,15370,8527,7379,1148,33910
2023,36008 Cangas,852,0,0,17,0,7,2,5,7,49,34,172,4,14,582,268,237,31,1120
2023,36017 Estrada (A),287,0,0,8,0,4,1,3,2,12,6,56,2,0,203,123,101,22,410
2023,36024 Lalín,345,0,0,14,0,2,0,2,2,16,8,77,2,4,228,155,137,18,500
2023,36026 Marín,447,0,1,4,0,7,0,7,3,26,9,102,4,5,295,146,133,13,593
2023,36042 Ponteareas,659,0,1,18,0,13,3,10,6,54,38,147,3,3,414,198,177,21,857
2023,36038 Pontevedra,2383,1,8,24,0,25,7,18,16,88,40,787,14,32,1388,706,614,92,3089
2023,"36039 Porriño, O",461,1,0,12,0,5,2,3,8,33,18,102,5,8,287,200,187,13,661
2023,36045 Redondela,588,0,0,5,0,3,1,2,5,41,17,116,10,4,404,261,215,46,849
2023,36057 Vigo,9006,1,9,130,0,124,36,88,211,616,333,3173,203,91,4448,3201,2691,510,12207
2023,36060 Vilagarcía de Arousa,1733,0,0,14,0,14,5,9,19,75,37,451,12,7,1141,267,230,37,2000
2023,MADRID (COMUNIDAD DE),332901,33,173,3357,19,2827,648,2179,12015,14557,9336,128366,7061,3389,161104,78881,71534,7347,411782
2023,Provincia de MADRID,332901,33,173,3357,19,2827,648,2179,12015,14557,9336,128366,7061,3389,161104,78881,71534,7347,411782
2023,28005 Alcalá de Henares,7258,1,7,87,0,61,8,53,188,264,136,2349,221,64,4016,2448,2110,338,9706
2023,28006 Alcobendas,4005,2,1,41,0,52,12,40,78,209,136,1170,156,60,2236,1151,1031,120,5156
2023,28007 Alcorcón,5939,0,3,46,0,33,4,29,194,188,115,2512,153,39,2771,1637,1453,184,7576
2023,28009 Algete,624,0,0,5,0,7,3,4,10,85,67,138,10,2,367,295,268,27,919
2023,28013 Aranjuez,2219,1,2,10,0,15,2,13,46,122,77,631,39,17,1336,635,588,47,2854
2023,28014 Arganda del Rey,2943,0,1,34,0,34,5,29,116,181,116,973,29,30,1545,759,669,90,3702
2023,28015 Arroyomolinos,2343,0,0,25,4,8,0,8,30,91,73,1291,58,7,829,585,511,74,2928
2023,28022 Boadilla del Monte,1503,0,1,24,0,20,4,16,20,169,139,406,12,7,844,959,860,99,2462
2023,28040 Ciempozuelos,1143,0,2,22,0,17,2,15,46,106,67,229,20,9,692,332,287,45,1475
2023,28047 Collado Villalba,2632,0,1,42,0,33,5,28,72,157,86,746,21,9,1551,484,386,98,3116
2023,28045 Colmenar Viejo,1925,0,2,31,0,19,0,19,48,124,92,569,14,8,1110,547,520,27,2472
2023,28049 Coslada,2669,0,0,17,0,19,2,17,56,164,68,907,80,30,1396,677,650,27,3346
2023,28058 Fuenlabrada,4749,1,2,24,0,42,17,25,184,213,113,1505,248,51,2479,1313,1245,68,6062
2023,28061 Galapagar,1389,0,0,46,0,20,5,15,27,132,115,208,8,9,939,533,442,91,1922
2023,28065 Getafe,7193,1,0,35,0,66,13,53,259,276,129,2424,263,32,3837,1894,1783,111,9087
2023,28074 Leganés,7822,0,2,55,2,83,22,61,245,325,167,3194,287,49,3580,1092,970,122,8914
2023,28079 Madrid,207592,20,118,1848,10,1674,411,1263,8691,7390,4593,88615,4013,2484,92729,40316,36878,3438,247908
2023,28080 Majadahonda,3357,0,0,55,0,31,3,28,53,184,112,1215,69,15,1735,1294,1158,136,4651
2023,28084 Mejorada del Campo,1083,1,1,17,1,8,1,7,17,56,34,205,26,11,740,354,322,32,1437
2023,28092 Móstoles,6435,2,5,56,0,54,21,33,211,329,219,1778,204,57,3739,2219,2048,171,8654
2023,28096 Navalcarnero,1075,0,1,13,0,17,1,16,14,55,45,237,37,13,688,482,417,65,1557
2023,28104 Paracuellos de Jarama,652,0,0,7,0,16,1,15,14,67,46,119,27,4,398,444,382,62,1096
2023,28106 Parla,5370,0,3,42,0,40,14,26,275,173,68,1633,84,25,3095,1159,1103,56,6529
2023,28113 Pinto,2365,0,3,33,0,21,5,16,46,123,83,786,17,20,1316,751,676,75,3116
2023,28115 Pozuelo de Alarcón,1905,0,0,23,0,13,4,9,32,106,86,708,68,20,935,387,341,46,2292
2023,28123 Rivas-Vaciamadrid,4330,0,1,62,0,28,7,21,136,381,257,1830,54,17,1821,1458,1362,96,5788
2023,28127 Rozas de Madrid (Las),3211,0,2,58,0,28,5,23,93,216,173,1321,35,8,1450,1558,1384,174,4769
2023,28130 San Fernando de Henares,1471,0,0,9,0,7,2,5,47,31,11,516,66,7,788,330,307,23,1801
2023,28134 San Sebastián de los Reyes,3627,0,2,32,0,21,3,18,72,162,103,1507,76,25,1730,791,722,69,4418
2023,28132 San Martín de la Vega,653,0,0,9,0,6,0,6,9,26,16,185,7,5,406,242,216,26,895
2023,28148 Torrejón de Ardoz,4476,0,3,49,0,37,15,22,104,118,73,1614,94,48,2409,909,805,104,5385
2023,28152 Torrelodones,859,0,0,14,0,11,1,10,15,91,77,280,6,5,437,434,383,51,1293
2023,28903 Tres Cantos,1106,0,0,17,0,10,2,8,16,80,56,411,2,2,568,500,456,44,1606
2023,28161 Valdemoro,3014,0,1,74,0,29,9,20,60,103,62,785,44,14,1904,1069,932,137,4083
2023,28176 Villanueva de la Cañada,849,0,0,9,0,16,3,13,18,69,61,299,3,10,425,254,236,18,1103
2023,28181 Villaviciosa de Odón,1082,0,0,17,0,9,2,7,37,124,110,301,8,6,580,332,280,52,1414
2023,MURCIA (REGION DE),60446,15,65,1173,4,662,110,552,2071,5324,3909,16564,970,580,33018,13748,12310,1438,74194
2023,Provincia de MURCIA,60446,15,65,1173,4,662,110,552,2071,5324,3909,16564,970,580,33018,13748,12310,1438,74194
2023,30003 Águilas,1891,0,5,21,0,13,3,10,49,161,116,727,13,11,891,320,293,27,2211
2023,30005 Alcantarilla,1224,0,6,19,0,19,3,16,42,82,48,309,19,22,706,330,297,33,1554
2023,30008 Alhama de Murcia,751,0,0,29,0,13,1,12,15,59,53,150,6,2,477,223,196,27,974
2023,30009 Archena,666,0,3,24,0,4,0,4,5,54,37,142,4,5,425,173,163,10,839
2023,30015 Caravaca de la Cruz,705,0,1,11,0,10,0,10,12,68,49,163,8,11,421,247,224,23,952
2023,30016 Cartagena,7879,5,7,121,1,83,9,74,184,548,370,2265,111,78,4476,2038,1809,229,9917
2023,30019 Cieza,1204,1,1,27,0,24,1,23,27,86,78,293,5,7,733,339,317,22,1543
2023,30022 Jumilla,1140,1,1,26,0,4,0,4,41,121,92,224,3,3,716,234,215,19,1374
2023,30024 Lorca,2866,1,8,61,0,42,7,35,114,225,150,661,26,23,1705,763,695,68,3629
2023,30026 Mazarrón,1487,0,0,55,0,15,1,14,22,167,135,377,14,11,826,290,253,37,1777
2023,30027 Molina de Segura,2093,0,1,22,0,25,9,16,92,247,200,602,44,23,1037,606,562,44,2699
2023,30030 Murcia,21765,4,23,351,2,206,42,164,1098,1717,1101,6547,484,255,11078,4138,3645,493,25903
2023,30035 San Javier,2299,0,2,31,0,16,3,13,37,239,195,859,28,7,1080,322,296,26,2621
2023,30036 San Pedro del Pinatar,1556,0,0,16,0,20,5,15,42,122,101,615,8,3,730,226,201,25,1782
2023,30037 Torre-Pacheco,1446,0,0,21,0,10,0,10,53,147,90,318,31,3,863,271,236,35,1717
2023,30038 Torres de Cotillas (Las),721,0,0,16,0,9,0,9,20,100,87,138,11,3,424,185,168,17,906
2023,30039 Totana,1161,0,1,80,0,44,5,39,49,90,75,262,10,4,621,270,223,47,1431
2023,30041 La Unión,651,0,0,13,0,8,0,8,13,30,22,160,6,8,413,221,189,32,872
2023,30043 Yecla,745,2,0,21,1,11,2,9,5,70,64,118,17,5,495,289,273,16,1034
2023,NAVARRA (COMUNIDAD FORAL DE),27619,6,32,380,0,412,81,331,467,1508,1034,8661,154,158,15841,7475,6576,899,35094
2023,Provincia de NAVARRA,27619,6,32,380,0,412,81,331,467,1508,1034,8661,154,158,15841,7475,6576,899,35094
2023,31060 Burlada/Burlata,542,0,0,9,0,10,6,4,7,24,17,126,6,3,357,128,110,18,670
2023,31201 Pamplona/Iruña,12703,3,13,78,0,192,27,165,316,366,225,5653,48,89,5945,2690,2369,321,15393
2023,31232 Tudela,2275,1,3,49,0,18,5,13,52,173,117,572,22,11,1374,288,257,31,2563
2023,31086 Valle de Egüés/Eguesibar,494,0,2,8,0,10,2,8,3,59,53,67,6,0,339,232,195,37,726
2023,PAÍS VASCO,79919,6,44,1658,9,829,231,598,2107,6411,4079,30129,751,597,37378,27904,25095,2809,107823
2023,Provincia de ARABA/ÁLAVA,11023,1,6,230,0,121,30,91,114,681,434,4184,74,128,5484,4653,4139,514,15676
2023,01059 Vitoria-Gasteiz,8500,1,5,180,0,93,23,70,105,363,218,3726,49,81,3897,3661,3273,388,12161
2023,Provincia de GIPUZKOA,24159,2,24,762,6,289,74,215,489,2548,1572,7403,256,254,12126,8761,7895,866,32920
2023,20055 Arrasate/Mondragón,490,0,0,22,0,10,3,7,7,59,39,147,2,11,232,278,251,27,768
2023,20069 Donostia/San Sebastián,7645,0,14,295,2,106,21,85,235,660,474,2808,77,81,3367,2238,2006,232,9883
2023,20030 Eibar,1201,0,0,38,0,18,8,10,20,123,55,376,12,17,597,401,369,32,1602
2023,20067 Errenteria,1151,0,0,51,0,14,3,11,29,53,36,312,14,9,669,533,487,46,1684
2023,20040 Hernani,715,0,0,15,0,7,1,6,8,79,41,184,12,6,404,183,165,18,898
2023,20045 Irun,3176,1,1,93,0,45,14,31,88,167,96,1008,40,39,1694,1105,1014,91,4281
2023,20071 Tolosa,1013,0,1,20,1,10,5,5,15,103,48,464,8,4,387,319,297,22,1332
2023,20079 Zarautz,737,0,0,21,0,7,0,7,7,138,103,265,15,9,275,300,284,16,1037
2023,Provincia de BIZKAIA,44737,3,14,666,3,419,127,292,1504,3182,2073,18542,421,215,19768,14490,13061,1429,59227
2023,48013 Barakaldo,4443,0,3,41,0,35,14,21,218,254,145,1680,49,21,2142,1133,1014,119,5576
2023,48015 Basauri,1490,0,0,24,0,16,6,10,28,77,35,591,16,6,732,521,481,40,2011
2023,48020 Bilbao,19005,2,5,260,1,123,47,76,832,717,469,10850,107,53,6055,4810,4321,489,23815
2023,48027 Durango,793,0,0,9,0,10,1,9,17,102,77,288,2,3,362,377,342,35,1170
2023,48902 Erandio,1026,0,0,27,0,17,5,12,48,49,22,338,6,5,536,388,350,38,1414
2023,48036 Galdakao,924,0,0,10,0,11,4,7,11,88,63,284,11,9,500,393,352,41,1317
2023,48044 Getxo,1851,0,0,48,0,23,10,13,80,254,215,601,15,6,824,912,843,69,2763
2023,48054 Leioa,849,0,0,9,0,3,2,1,27,75,60,316,33,6,380,353,313,40,1202
2023,48078 Portugalete,1538,0,0,20,0,6,0,6,28,117,55,679,7,6,675,477,429,48,2015
2023,48082 Santurtzi,1100,0,0,10,1,16,2,14,30,74,52,299,20,2,648,537,483,54,1637
2023,48084 Sestao,1034,0,1,19,0,11,3,8,35,70,29,298,10,5,585,378,333,45,1412
2023,RIOJA (LA),9788,3,12,237,2,113,18,95,150,727,559,2974,68,93,5409,2364,2021,343,12152
2023,Provincia de LA RIOJA,9788,3,12,237,2,113,18,95,150,727,559,2974,68,93,5409,2364,2021,343,12152
2023,26036 Calahorra,1222,0,0,33,0,12,2,10,18,71,54,319,3,7,759,196,159,37,1418
2023,26089 Logroño,4557,1,4,74,1,56,7,49,90,215,156,1875,49,58,2134,1045,917,128,5602
2023,CIUDAD AUTÓNOMA DE CEUTA,2949,5,6,57,0,41,8,33,84,52,33,529,108,99,1968,592,514,78,3541
2023,51001 Ceuta,2949,5,6,57,0,41,8,33,84,52,33,529,108,99,1968,592,514,78,3541
2023,CIUDAD AUTÓNOMA DE MELILLA,3876,0,3,118,0,39,3,36,119,121,60,747,65,60,2604,481,409,72,4357
2023,52001 Melilla,3876,0,3,118,0,39,3,36,119,121,60,747,65,60,2604,481,409,72,4357
2023,NACIONAL,1992499,333,1359,27087,122,20021,4880,15141,64711,122863,84721,665622,32839,21033,1036509,472260,427448,44812,2464759
